filename,p_true,p_pred,p_error,s_true,s_pred,s_error,ps_true,ps_pred,ps_error,p_prob_max,s_prob_max
GE.UGM.BL.gfz2010ddjw.npz,3001,3240,239,5719,3238,2481,2718,-2,2720,0.36692286,0.34177688
GE.TNTI.BL.gfz2009ayha.npz,3000,16902,13902,9659,7412,2247,6659,-9490,16149,0.34970382,0.33563814
GE.SOEI.BH.gfz2012mpmh.npz,3001,3304,303,6999,3310,3689,3998,6,3992,0.34913972,0.3402886
GE.MNAI.BL.gfz2009xyqn.npz,3001,4152,1151,4086,605,3481,1085,-3547,4632,0.39753154,0.32897902
GE.LHMI.SH.gfz2013urpd.npz,3001,904,2097,4666,1228,3438,1665,324,1341,0.3518812,0.3255106
GE.PLAI.SL.gfz2012xqdd.npz,3000,16878,13878,7549,16877,9328,4549,-1,-1,0.45936763,0.37486878
GE.MMRI.SH.gfz2013hbue.npz,3000,3526,526,6667,3340,3327,3667,-186,3853,0.3503777,0.32728657
GE.BNDI.SH.gfz2018qhyw.npz,3000,4658,1658,4533,4719,186,1533,61,1472,0.3678919,0.34630916
GE.TNTI.BL.gfz2009fgfn.npz,3001,3519,518,6549,3584,2965,3548,65,3483,0.34680495,0.33313623
GE.MMRI.BL.gfz2019hinv.npz,3001,5605,2604,5213,784,4429,2212,-4821,7033,0.34804133,0.3384892
GE.FAKI.BH.gfz2009ayxo.npz,3001,6184,3183,8473,3675,4798,5472,-2509,7981,0.33569473,0.3254725
GE.SOEI.BL.gfz2013yfql.npz,3001,3146,145,3736,3978,242,735,832,97,0.35557362,0.33057687
GE.GSI.BH.gfz2012uhbt.npz,3001,4890,1889,4276,4722,446,1275,-168,1443,0.34245196,0.32956523
GE.LHMI.BL.gfz2012rato.npz,3001,1701,1300,4813,11265,6452,1812,9564,7752,0.41546664,0.3374984
GE.LUWI.HH.gfz2009qkjn.npz,3000,5174,2174,5035,6229,1194,2035,1055,980,0.34977332,0.33211443
GE.PLAI.SH.gfz2024yqam.npz,3001,7026,4025,6897,7111,214,3896,85,3811,0.34269562,0.33361846
GE.GSI.BL.gfz2021kfyy.npz,3001,3044,43,5467,5629,162,2466,2585,119,0.36320907,0.33385113
GE.MMRI.SH.gfz2024wupd.npz,3001,2396,605,7869,2699,5170,4868,303,4565,0.37679294,0.3342798
GE.PLAI.SL.gfz2017ddhx.npz,3000,3188,188,6217,3145,3072,3217,-43,3260,0.39959642,0.35284737
GE.BBJI.BH.gfz2024nomt.npz,3001,6701,3700,5838,6412,574,2837,-289,3126,0.3448995,0.3241741
GE.LUWI.SH.gfz2010abbl.npz,3001,1560,1441,8712,1533,7179,5711,-27,5738,0.41622856,0.33710012
GE.JAGI.SH.gfz2012qetk.npz,3001,4600,1599,4295,4367,72,1294,-233,1527,0.3658902,0.353754
GE.LUWI.BL.gfz2010ciep.npz,3001,4573,1572,4317,4570,253,1316,-3,1319,0.38302836,0.34334671
GE.FAKI.BH.gfz2012amyi.npz,3001,8168,5167,7987,3124,4863,4986,-5044,10030,0.3516716,0.32618746
GE.BNDI.BH.gfz2012gezz.npz,3001,5305,2304,4821,605,4216,1820,-4700,6520,0.34485418,0.32498524
GE.JAGI.SH.gfz2013hbue.npz,3001,8893,5892,8466,3065,5401,5465,-5828,11293,0.35741007,0.33787656
GE.GSI.SH.gfz2015bvov.npz,3000,1490,1510,3884,991,2893,884,-499,1383,0.37815017,0.33808407
GE.SAUI.BH.gfz2020iiaf.npz,3001,1,3000,4910,3135,1775,1909,3134,1225,0.34173894,0.33026174
GE.JAGI.BH.gfz2017nmdx.npz,3001,5046,2045,4595,4864,269,1594,-182,1776,0.3484408,0.32943764
GE.FAKI.HL.gfz2009bmox.npz,3000,1352,1648,9002,6253,2749,6002,4901,1101,0.5143743,0.36848924
GE.GSI.BH.gfz2013qpmq.npz,3001,5340,2339,5213,5360,147,2212,20,2192,0.3506888,0.3314459
GE.SOEI.BH.gfz2009rpju.npz,3001,1,3000,10619,3,10616,7618,2,7616,0.33977154,0.32240972
GE.FAKI.BL.gfz2009daap.npz,3001,3236,235,8275,15957,7682,5274,12721,7447,0.37122697,0.33014643
GE.LUWI.HL.gfz2009ilut.npz,3000,11304,8304,11427,9706,1721,8427,-1598,10025,0.79872787,0.46866006
GE.FAKI.BH.gfz2009yode.npz,3001,6086,3085,5932,6117,185,2931,31,2900,0.37371916,0.3294693
GE.FAKI.BL.gfz2013wlbf.npz,3001,484,2517,5560,11064,5504,2559,10580,8021,0.35321584,0.3274643
GE.TNTI.HL.gfz2009rdgk.npz,3000,14344,11344,5206,13397,8191,2206,-947,3153,0.6537237,0.3576643
GE.MMRI.BH.gfz2025amik.npz,3001,4119,1118,6520,4121,2399,3519,2,3517,0.34022182,0.3235543
GE.SAUI.HH.gfz2009tkfn.npz,3000,834,2166,11707,1536,10171,8707,702,8005,0.43119052,0.33099687
GE.TNTI.BL.gfz2009bmox.npz,3002,14728,11726,5029,5962,933,2027,-8766,10793,0.34249988,0.3413865
GE.LUWI.BL.gfz2009bjnh.npz,3001,647,2354,11853,888,10965,8852,241,8611,0.3466857,0.3350123
GE.MMRI.BL.gfz2012ugap.npz,3001,1476,1525,5375,2,5373,2374,-1474,3848,0.35126328,0.33669263
GE.FAKI.BL.gfz2009aqpt.npz,3001,3340,339,6401,3352,3049,3400,12,3388,0.34806582,0.33513296
GE.TNTI.BL.gfz2009czsb.npz,3001,518,2483,6556,849,5707,3555,331,3224,0.33941752,0.32964274
GE.TNTI.SH.gfz2012yhuy.npz,3000,1658,1342,7567,1589,5978,4567,-69,4636,0.3366568,0.32648456
GE.UGM.SL.gfz2014bxsc.npz,3001,3022,21,4752,3186,1566,1751,164,1587,0.4209475,0.3506359
GE.SOEI.SH.gfz2013qvir.npz,3000,1047,1953,8059,1413,6646,5059,366,4693,0.35384986,0.33877707
GE.UGM.SH.gfz2012uneo.npz,3000,3480,480,6797,8031,1234,3797,4551,754,0.33233383,0.3220923
GE.JAGI.BH.gfz2024xkub.npz,3001,4248,1247,4170,4257,87,1169,9,1160,0.38687107,0.3393693
GE.TOLI2.SH.gfz2013hjin.npz,3001,3032,31,10615,3131,7484,7614,99,7515,0.36025172,0.34122276
GE.MMRI.HH.gfz2009ilut.npz,3000,1404,1596,9475,2294,7181,6475,890,5585,0.39519832,0.34806573
GE.LUWI.BL.gfz2012wmnj.npz,3001,3144,143,4934,5219,285,1933,2075,142,0.38226283,0.33934668
GE.FAKI.HH.gfz2009atqt.npz,3000,1320,1680,6303,3270,3033,3303,1950,1353,0.38077912,0.342353
GE.BKNI.SH.gfz2022gjiw.npz,3001,828,2173,6140,492,5648,3139,-336,3475,0.34324768,0.32812417
GE.TNTI.BH.gfz2009frwm.npz,3001,2356,645,6454,16627,10173,3453,14271,10818,0.33814213,0.33558607
GE.FAKI.BH.gfz2009rpju.npz,3001,7672,4671,7454,3141,4313,4453,-4531,8984,0.35546502,0.33471096
GE.SMRI.SH.gfz2015vcni.npz,3001,724,2277,5258,3329,1929,2257,2605,348,0.38397145,0.32962704
GE.SAUI.BL.gfz2010kolf.npz,3001,3048,47,5503,3055,2448,2502,7,2495,0.3474872,0.3348993
GE.UGM.SH.gfz2012atnm.npz,3001,4526,1525,4416,4555,139,1415,29,1386,0.35950997,0.3311657
GE.PLAI.BH.gfz2019cznc.npz,3001,5114,2113,4364,4828,464,1363,-286,1649,0.3440086,0.32614434
GE.TNTI.BH.gfz2013rzij.npz,3001,5718,2717,4609,3405,1204,1608,-2313,3921,0.34056205,0.3282949
GE.SAUI.HH.gfz2009sufe.npz,3000,404,2596,5196,1250,3946,2196,846,1350,0.41801864,0.34207577
GE.FAKI.HL.gfz2009bgxf.npz,3000,15384,12384,5890,1490,4400,2890,-13894,16784,0.6361811,0.47272578
GE.SAUI.SH.gfz2021ubnw.npz,3000,1240,1760,4858,1357,3501,1858,117,1741,0.3965069,0.35790363
GE.TNTI.BL.gfz2013rzij.npz,3001,13868,10867,4609,3234,1375,1608,-10634,12242,0.34499544,0.33409503
GE.UGM.SH.gfz2010fnia.npz,3000,5010,2010,4764,4950,186,1764,-60,1824,0.34379965,0.3351711
GE.SMRI.BH.gfz2013jvgk.npz,3001,8518,5517,7004,5787,1217,4003,-2731,6734,0.33508745,0.323181
GE.SMRI.BH.gfz2009boyf.npz,3002,6260,3258,6155,16171,10016,3153,9911,6758,0.33699727,0.32540515
GE.LHMI.BL.gfz2013urpd.npz,3001,5175,2174,4666,3554,1112,1665,-1621,3286,0.34328353,0.33079526
GE.MNAI.BH.gfz2010atkp.npz,3001,4428,1427,4187,4372,185,1186,-56,1242,0.36613384,0.32713914
GE.FAKI.HH.gfz2009dkli.npz,3000,424,2576,12495,461,12034,9495,37,9458,0.5201633,0.3618347
GE.TNTI.HH.gfz2009qghs.npz,3000,1112,1888,5191,705,4486,2191,-407,2598,0.41621596,0.327238
GE.MMRI.BH.gfz2013fkbz.npz,3002,5400,2398,5505,6146,641,2503,746,1757,0.3369532,0.32641017
GE.TNTI.BH.gfz2010awor.npz,3001,3596,595,7411,3301,4110,4410,-295,4705,0.34325323,0.33170855
GE.TNTI.HL.gfz2009bmox.npz,3000,824,2176,5027,986,4041,2027,162,1865,0.46826497,0.35906202
GE.MMRI.BH.gfz2024wupd.npz,3002,5722,2720,7870,1197,6673,4868,-4525,9393,0.3402978,0.32563502
GE.UGM.BH.gfz2009ptvf.npz,3001,5374,2373,4988,5149,161,1987,-225,2212,0.33514068,0.3258377
GE.TOLI2.SH.gfz2012yhuy.npz,3000,998,2002,11977,252,11725,8977,-746,9723,0.33130574,0.32503024
GE.FAKI.BL.gfz2009avte.npz,3000,3306,306,8234,8278,44,5234,4972,262,0.38740382,0.331162
GE.LUWI.HL.gfz2009floe.npz,3000,408,2592,6111,13170,7059,3111,12762,9651,0.8114439,0.41684613
GE.JAGI.BL.gfz2012rjfs.npz,3002,3316,314,5948,16986,11038,2946,13670,10724,0.3583041,0.32846773
GE.SOEI.BH.gfz2012heuj.npz,3001,4,2997,9064,9419,355,6063,9415,3352,0.34251264,0.32237306
GE.TNTI.BH.gfz2024qrxn.npz,3001,5364,2363,4820,5,4815,1819,-5359,7178,0.37108132,0.3296351
GE.SANI.SH.gfz2015thvg.npz,3000,3188,188,6552,3165,3387,3552,-23,3575,0.4033741,0.35980076
GE.TNTI.BH.gfz2009dseu.npz,3001,1,3000,6481,3404,3077,3480,3403,77,0.33913663,0.32640648
GE.LUWI.SH.gfz2017cdvt.npz,3001,1308,1693,4261,4520,259,1260,3212,1952,0.4230542,0.33050495
GE.GSI.SH.gfz2010wlnb.npz,3000,552,2448,5862,833,5029,2862,281,2581,0.41610587,0.34467313
GE.MNAI.BL.gfz2013ydaj.npz,3000,5003,2003,4816,5097,281,1816,94,1722,0.36196953,0.34680176
GE.GENI.SH.gfz2012nver.npz,3000,4042,1042,3965,4029,64,965,-13,978,0.36578473,0.32996982
GE.LUWI.BH.gfz2009bjnh.npz,3001,8360,5359,11853,8937,2916,8852,577,8275,0.33079213,0.32281283
GE.UGM.BH.gfz2016dbtc.npz,3001,3198,197,5389,3141,2248,2388,-57,2445,0.33457416,0.32373458
GE.TOLI2.SH.gfz2025dlfh.npz,3000,5236,2236,5084,5326,242,2084,90,1994,0.37400636,0.3393888
GE.UGM.BH.gfz2010fnia.npz,3001,5014,2013,4765,5311,546,1764,297,1467,0.34777784,0.32435066
GE.TOLI2.BL.gfz2025bymb.npz,3001,4696,1695,4214,4535,321,1213,-161,1374,0.36374208,0.33147845
GE.PLAI.BL.gfz2012dcye.npz,3001,4200,1199,4107,4197,90,1106,-3,1109,0.3725165,0.3387938
GE.FAKI.HL.gfz2009tkfn.npz,3000,312,2688,6328,3410,2918,3328,3098,230,0.5584058,0.36481902
GE.SOEI.HH.gfz2009qfbt.npz,3000,3394,394,8523,3256,5267,5523,-138,5661,0.34666488,0.3322041
GE.FAKI.SH.gfz2009zbqz.npz,3000,3171,171,8099,3328,4771,5099,157,4942,0.3617547,0.33710003
GE.PLAI.BL.gfz2014ghxq.npz,3001,3262,261,5977,6170,193,2976,2908,68,0.352054,0.33884832
GE.TOLI2.BH.gfz2024qmwb.npz,3001,12342,9341,11311,3342,7969,8310,-9000,17310,0.33771953,0.32852352
GE.PLAI.BH.gfz2025bckw.npz,3001,4639,1638,4563,4685,122,1562,46,1516,0.3424034,0.33850637
GE.MNAI.BH.gfz2013xmza.npz,3001,4026,1025,4007,4199,192,1006,173,833,0.36370078,0.33421835
GE.MNAI.HL.gfz2009rjtx.npz,3000,15934,12934,8202,3534,4668,5202,-12400,17602,0.404514,0.37670946
GE.GSI.SH.gfz2013cxen.npz,3000,3182,182,5901,3066,2835,2901,-116,3017,0.398623,0.3359718
GE.UGM.BL.gfz2013crnj.npz,3001,4869,1868,4648,4722,74,1647,-147,1794,0.35508645,0.33975098
GE.UGM.SL.gfz2013ttpe.npz,3000,3294,294,4938,3153,1785,1938,-141,2079,0.40788716,0.3412616
GE.FAKI.BH.gfz2009aixg.npz,3001,3550,549,6068,3205,2863,3067,-345,3412,0.3424774,0.3268091
GE.FAKI.BL.gfz2009zbqz.npz,3001,3188,187,8100,3475,4625,5099,287,4812,0.37289742,0.32663542
GE.FAKI.BL.gfz2012cnkn.npz,3001,6957,3956,6386,3418,2968,3385,-3539,6924,0.36592138,0.33290473
GE.GSI.SH.gfz2021kfyy.npz,3000,3032,32,5466,3053,2413,2466,21,2445,0.3474193,0.3277897
GE.SMRI.HL.gfz2009boyf.npz,3000,16705,13705,6153,16714,10561,3153,9,3144,0.64871585,0.5486697
GE.TNTI.HL.gfz2009agwc.npz,3000,536,2464,8357,16904,8547,5357,16368,11011,0.540509,0.38292563
GE.BKNI.BH.gfz2012gitd.npz,3001,4506,1505,4376,4825,449,1375,319,1056,0.34888175,0.32752767
GE.SOEI.BL.gfz2025gvra.npz,3001,3346,345,9939,3155,6784,6938,-191,7129,0.3413773,0.32968685
GE.LHMI.BL.gfz2011kyss.npz,3000,5512,2512,4774,3167,1607,1774,-2345,4119,0.34861478,0.33294347
GE.TNTI.BH.gfz2009hmmo.npz,3002,798,2204,5880,1016,4864,2878,218,2660,0.34654978,0.33602104
GE.FAKI.HL.gfz2009ewtf.npz,3000,10436,7436,10975,13330,2355,7975,2894,5081,0.5596116,0.40830573
GE.FAKI.HH.gfz2009ayty.npz,3000,1240,1760,6316,1237,5079,3316,-3,3319,0.39556718,0.34853357
GE.UGM.BL.gfz2009bbud.npz,3001,5527,2526,5427,5528,101,2426,1,2425,0.34843966,0.33783332
GE.UGM.SH.gfz2014kwfg.npz,3001,4770,1769,4692,4758,66,1691,-12,1703,0.3504961,0.35883012
GE.SAUI.BL.gfz2013tulg.npz,3001,3831,830,6696,6957,261,3695,3126,569,0.3464341,0.3376824
GE.UGM.BH.gfz2009bjnh.npz,3000,6440,3440,13085,5947,7138,10085,-493,10578,0.33001673,0.3221224
GE.SANI.BH.gfz2011xxju.npz,3001,5562,2561,5398,3103,2295,2397,-2459,4856,0.3685655,0.3334334
GE.FAKI.HL.gfz2009nqxv.npz,3000,3448,448,7630,16954,9324,4630,13506,8876,0.4834801,0.37744182
GE.PLAI.SH.gfz2017culr.npz,3001,4674,1673,4408,3023,1385,1407,-1651,3058,0.35614094,0.3314078
GE.LUWI.BH.gfz2009floe.npz,3001,6206,3205,6112,3186,2926,3111,-3020,6131,0.37393054,0.34353396
GE.SANI.SH.gfz2013grue.npz,3000,3504,504,11086,3518,7568,8086,14,8072,0.3818735,0.3520741
GE.FAKI.BL.gfz2009cdlz.npz,3001,4,2997,7166,3157,4009,4165,3153,1012,0.3748949,0.34110522
GE.MMRI.BH.gfz2013ribh.npz,3001,4642,1641,4455,4234,221,1454,-408,1862,0.3409639,0.32727623
GE.LHMI.HL.gfz2009epev.npz,3000,1000,2000,4127,4726,599,1127,3726,2599,0.41485596,0.35632572
GE.TNTI.BL.gfz2009qgjm.npz,3001,4813,1812,4572,4874,302,1571,61,1510,0.34386617,0.3303169
GE.MMRI.BL.gfz2013hbue.npz,3001,14756,11755,6668,7322,654,3667,-7434,11101,0.34474608,0.33700526
GE.JAGI.BL.gfz2009zipp.npz,3001,8146,5145,7122,7629,507,4121,-517,4638,0.35376155,0.33738792
GE.BNDI.BL.gfz2017bxmp.npz,3001,3177,176,5531,3254,2277,2530,77,2453,0.35500178,0.33981222
GE.GSI.BH.gfz2022twah.npz,3001,4504,1503,3922,4574,652,921,70,851,0.34381834,0.33099562
GE.MMRI.BH.gfz2022sqkl.npz,3001,3645,644,6512,3317,3195,3511,-328,3839,0.3346943,0.3255642
GE.TNTI.HH.gfz2009agwc.npz,3000,456,2544,8357,3304,5053,5357,2848,2509,0.34977457,0.32773197
GE.MNAI.SH.gfz2021lyjz.npz,3001,3,2998,3840,3880,40,839,3877,3038,0.42664224,0.33763376
GE.FAKI.HL.gfz2009aczt.npz,3000,7160,4160,13085,10386,2699,10085,3226,6859,0.4542709,0.35770252
GE.FAKI.BH.gfz2010kolf.npz,3000,8344,5344,8220,5377,2843,5220,-2967,8187,0.34939763,0.3259967
GE.LUWI.SH.gfz2024hdte.npz,3001,1684,1317,10475,1867,8608,7474,183,7291,0.37815374,0.33928782
GE.SOEI.HH.gfz2009rpju.npz,3000,1,2999,10618,3,10615,7618,2,7616,0.33449608,0.33242646
GE.PLAI.BH.gfz2014esmj.npz,3001,3779,778,6214,15280,9066,3213,11501,8288,0.34170857,0.3248076
GE.PLAI.SH.gfz2022sqkl.npz,3001,5210,2209,5093,3230,1863,2092,-1980,4072,0.3728487,0.33535442
GE.FAKI.BL.gfz2009ayty.npz,3000,3256,256,6316,3246,3070,3316,-10,3326,0.3596066,0.33667687
GE.PMBI.BL.gfz2011swwe.npz,3000,15400,12400,5673,7462,1789,2673,-7938,10611,0.39726642,0.3474675
GE.UGM.BL.gfz2010bjpa.npz,3001,3158,157,6717,6972,255,3716,3814,98,0.35019928,0.32712844
GE.TNTI.HH.gfz2009algf.npz,3000,468,2532,4726,1020,3706,1726,552,1174,0.36811072,0.3374547
GE.TNTI.BH.gfz2020iwiv.npz,3001,762,2239,4420,828,3592,1419,66,1353,0.33549118,0.32536662
GE.TNTI.SH.gfz2014hjch.npz,3001,511,2490,4447,540,3907,1446,29,1417,0.3530551,0.32681277
GE.LUWI.BL.gfz2012rszr.npz,3001,6536,3535,6320,3104,3216,3319,-3432,6751,0.3766919,0.34974995
GE.GSI.BH.gfz2022gjiw.npz,3000,5499,2499,5410,3071,2339,2410,-2428,4838,0.36332142,0.33195028
GE.TOLI2.SH.gfz2025bymb.npz,3001,2,2999,4214,4,4210,1213,2,1211,0.59845334,0.45705125
GE.SOEI.BL.gfz2025dcky.npz,3000,4246,1246,9361,9787,426,6361,5541,820,0.3460361,0.33337265
GE.TNTI.BH.gfz2017ayqr.npz,3001,4661,1660,4346,4663,317,1345,2,1343,0.33446756,0.32461464
GE.TNTI.SH.gfz2014jcyq.npz,3000,16877,13877,7235,3386,3849,4235,-13491,17726,0.40233168,0.33401614
GE.SAUI.SH.gfz2013aruy.npz,3000,3182,182,5769,3298,2471,2769,116,2653,0.37461367,0.340064
GE.TNTI.BH.gfz2009czsb.npz,3001,376,2625,6556,1104,5452,3555,728,2827,0.33383882,0.32389164
GE.PLAI.BH.gfz2019usec.npz,3001,4308,1307,4222,4297,75,1221,-11,1232,0.36293304,0.33602715
GE.GSI.BH.gfz2009cktz.npz,3001,466,2535,5152,3130,2022,2151,2664,513,0.36012912,0.33080834
GE.MNAI.HL.gfz2009mwyd.npz,3000,1288,1712,5775,17,5758,2775,-1271,4046,0.40559143,0.35040948
GE.FAKI.BL.gfz2009agmj.npz,3001,3278,277,6180,3473,2707,3179,195,2984,0.35812345,0.3312787
GE.FAKI.SH.gfz2014fbzr.npz,3000,3240,240,5986,3506,2480,2986,266,2720,0.3422607,0.32680565
GE.UGM.BL.gfz2012uneo.npz,3002,7256,4254,6799,7498,699,3797,242,3555,0.33962533,0.32751665
GE.SAUI.BH.gfz2016mcqf.npz,3001,5852,2851,5266,5854,588,2265,2,2263,0.3346407,0.32481432
GE.MMRI.BH.gfz2009efga.npz,3001,3870,869,9775,11111,1336,6774,7241,467,0.33454552,0.32532603
GE.BBJI.BL.gfz2018bubc.npz,3001,5188,2187,4926,5090,164,1925,-98,2023,0.36789906,0.33301336
GE.PLAI.BL.gfz2013sril.npz,3001,3592,591,5556,3779,1777,2555,187,2368,0.3572946,0.3299908
GE.SANI.BH.gfz2013nflx.npz,3001,3136,135,8963,3152,5811,5962,16,5946,0.34415695,0.32432133
GE.PLAI.SH.gfz2025bmwa.npz,3001,5288,2287,5233,5420,187,2232,132,2100,0.36596227,0.32640383
GE.MMRI.BH.gfz2009ilut.npz,3002,10692,7690,9477,3448,6029,6475,-7244,13719,0.33974904,0.3272496
GE.GSI.BL.gfz2016rfim.npz,3001,5357,2356,4568,5329,761,1567,-28,1595,0.3369957,0.328772
GE.BBJI.BH.gfz2024xqwc.npz,3001,4129,1128,4051,4420,369,1050,291,759,0.35894504,0.3255553
GE.TNTI.HL.gfz2009waho.npz,3000,168,2832,5791,16877,11086,2791,16709,13918,0.520074,0.3579163
GE.TNTI.BH.gfz2009eqqh.npz,3001,225,2776,4182,1154,3028,1181,929,252,0.3384731,0.32414487
GE.JAGI.BH.gfz2009ruvn.npz,3001,4132,1131,7304,8143,839,4303,4011,292,0.3396158,0.32412416
GE.JAGI.HH.gfz2009bkhv.npz,3000,6196,3196,5823,6269,446,2823,73,2750,0.3465517,0.33191574
GE.TNTI.BH.gfz2024fmvg.npz,3002,808,2194,4405,914,3491,1403,106,1297,0.37049448,0.33179882
GE.SAUI.BL.gfz2020iiaf.npz,3001,1082,1919,4910,1073,3837,1909,-9,1918,0.36094096,0.3360263
GE.PLAI.SL.gfz2019qkjz.npz,3000,3124,124,4496,3121,1375,1496,-3,1499,0.41813597,0.3494666
GE.BNDI.SH.gfz2009yode.npz,3001,632,2369,5360,5860,500,2359,5228,2869,0.3446944,0.3342194
GE.UGM.BH.gfz2010teou.npz,3001,3552,551,7812,3511,4301,4811,-41,4852,0.34022316,0.32410955
GE.SAUI.BL.gfz2009sufe.npz,3001,5854,2853,5197,5749,552,2196,-105,2301,0.3449252,0.32958272
GE.GSI.SH.gfz2012nrpy.npz,3000,14272,11272,9273,6621,2652,6273,-7651,13924,0.34765798,0.3274457
GE.SMRI.BH.gfz2018hcuv.npz,3001,3063,62,5522,5774,252,2521,2711,190,0.35710108,0.33042616
GE.TNTI.BL.gfz2009dijd.npz,3002,776,2226,5353,1317,4036,2351,541,1810,0.33945128,0.32860938
GE.SANI.BL.gfz2015thvg.npz,3001,3170,169,6553,6694,141,3552,3524,28,0.36047548,0.3396871
GE.TNTI.BL.gfz2010abbl.npz,3001,5460,2459,4743,3877,866,1742,-1583,3325,0.3498083,0.33652902
GE.FAKI.BH.gfz2009oubh.npz,3001,8786,5785,8632,9208,576,5631,422,5209,0.3422352,0.32977372
GE.TNTI.BH.gfz2009eavu.npz,3002,8324,5322,8073,8934,861,5071,610,4461,0.34347317,0.32780087
GE.TNTI.BH.gfz2016mexu.npz,3002,4927,1925,3915,12610,8695,913,7683,6770,0.34249884,0.32427233
GE.UGM.SH.gfz2015kylx.npz,3001,3097,96,5107,3101,2006,2106,4,2102,0.34790263,0.32773143
GE.UGM.BL.gfz2009boyf.npz,3001,6420,3419,6030,6361,331,3029,-59,3088,0.35362497,0.3384551
GE.FAKI.SH.gfz2024quvs.npz,3001,9873,6872,8616,3745,4871,5615,-6128,11743,0.3352802,0.32619825
GE.FAKI.BH.gfz2009rhsi.npz,3001,7144,4143,7017,11826,4809,4016,4682,666,0.34999907,0.32502428
GE.BNDI.BH.gfz2025fwkg.npz,3001,3404,403,5529,3664,1865,2528,260,2268,0.33944923,0.32416978
GE.FAKI.BL.gfz2013avzn.npz,3001,3098,97,7374,3105,4269,4373,7,4366,0.38198668,0.34003878
GE.FAKI.HL.gfz2009blcy.npz,3000,13767,10767,5905,13794,7889,2905,27,2878,0.5669881,0.38793927
GE.GSI.BH.gfz2025cdqz.npz,3001,5569,2568,5079,5755,676,2078,186,1892,0.3412919,0.32289776
GE.TNTI.BH.gfz2009bmox.npz,3002,1188,1814,5029,1042,3987,2027,-146,2173,0.33762422,0.3321462
GE.LUWI.BL.gfz2013qwcb.npz,3000,7304,4304,6053,4096,1957,3053,-3208,6261,0.3604784,0.33488712
GE.TNTI.HH.gfz2009fgfn.npz,3000,3,2997,6548,16996,10448,3548,16993,13445,0.34258598,0.32081127
GE.LUWI.BH.gfz2017ukwz.npz,3001,4423,1422,4249,4494,245,1248,71,1177,0.36160922,0.3263149
GE.PLAI.SH.gfz2017nlxf.npz,3001,4827,1826,4473,4882,409,1472,55,1417,0.35240552,0.34984556
GE.LUWI.BH.gfz2012widq.npz,3001,5447,2446,5219,592,4627,2218,-4855,7073,0.34843,0.3258411
GE.MNAI.BL.gfz2013uvlo.npz,3002,8088,5086,7637,4246,3391,4635,-3842,8477,0.36249506,0.34122515
GE.MMRI.SH.gfz2012rbpj.npz,3001,616,2385,10204,1572,8632,7203,956,6247,0.33881977,0.3255675
GE.UGM.SH.gfz2012cipp.npz,3000,4770,1770,4696,5436,740,1696,666,1030,0.34374377,0.32504568
GE.GSI.SH.gfz2016rfim.npz,3001,5432,2431,4568,5194,626,1567,-238,1805,0.33944377,0.3243273
GE.SANI.SH.gfz2010ghiq.npz,3000,3429,429,9709,14783,5074,6709,11354,4645,0.34726757,0.3275747
GE.FAKI.BH.gfz2018qtuf.npz,3001,3166,165,5929,3089,2840,2928,-77,3005,0.36344787,0.33116606
GE.TOLI2.SH.gfz2014iwpt.npz,3000,4136,1136,6161,4256,1905,3161,120,3041,0.3391607,0.3265241
GE.BNDI.BH.gfz2025dcky.npz,3001,158,2843,6294,1265,5029,3293,1107,2186,0.3345649,0.3245297
GE.FAKI.BL.gfz2010abkc.npz,3001,8052,5051,7816,8058,242,4815,6,4809,0.37565896,0.34399188
GE.GSI.BH.gfz2012hidg.npz,3001,5474,2473,5178,5484,306,2177,10,2167,0.34373412,0.32406145
GE.SOEI.BL.gfz2014mnzy.npz,3001,5368,2367,4703,1003,3700,1702,-4365,6067,0.3465269,0.3262004
GE.FAKI.HL.gfz2009byjb.npz,3000,3240,240,7194,890,6304,4194,-2350,6544,0.5345352,0.456427
GE.MNAI.BL.gfz2020wrfa.npz,3001,3989,988,3937,4158,221,936,169,767,0.37761065,0.34215912
GE.JAGI.BL.gfz2023qwer.npz,3001,3364,363,8565,3344,5221,5564,-20,5584,0.34754613,0.3390946
GE.PLAI.SH.gfz2025ghay.npz,3000,4888,1888,4791,3190,1601,1791,-1698,3489,0.37994435,0.33402798
GE.MNAI.SH.gfz2009xyqn.npz,3000,4152,1152,4085,4293,208,1085,141,944,0.36603385,0.3370585
GE.JAGI.HH.gfz2009bjnh.npz,3000,1368,1632,13085,747,12338,10085,-621,10706,0.3394378,0.32562503
GE.BNDI.BL.gfz2010ghiq.npz,3001,3598,597,5661,7,5654,2660,-3591,6251,0.35569546,0.33390453
GE.JAGI.SH.gfz2024wupd.npz,3001,15304,12303,10182,3157,7025,7181,-12147,19328,0.36548078,0.34163934
GE.TNTI.BL.gfz2009sidp.npz,3001,5438,2437,4938,5501,563,1937,63,1874,0.33979517,0.32640967
GE.FAKI.BH.gfz2012xahl.npz,3001,6586,3585,6339,6582,243,3338,-4,3342,0.35488254,0.33263603
GE.FAKI.HL.gfz2009ennn.npz,3000,56,2944,7655,10984,3329,4655,10928,6273,0.54575,0.45167527
GE.UGM.HH.gfz2009inbh.npz,3000,5976,2976,5968,3300,2668,2968,-2676,5644,0.33457637,0.32622287
GE.UGM.HL.gfz2009bbud.npz,3000,1212,1788,5426,5598,172,2426,4386,1960,0.43284434,0.34043914
GE.MNAI.SH.gfz2012wvgj.npz,3000,5536,2536,5307,5606,299,2307,70,2237,0.35951057,0.3338206
GE.PLAI.SH.gfz2012qetk.npz,3001,7852,4851,7071,3281,3790,4070,-4571,8641,0.35531,0.3296032
GE.FAKI.BL.gfz2009bjnh.npz,3001,6716,3715,6603,12318,5715,3602,5602,2000,0.3643717,0.32732227
GE.MNAI.BL.gfz2009pxkx.npz,3002,16007,13005,6811,7732,921,3809,-8275,12084,0.35126117,0.33251357
GE.UGM.SL.gfz2010cvnw.npz,3000,3320,320,4749,515,4234,1749,-2805,4554,0.3641581,0.33903146
GE.SANI.BL.gfz2025ewvp.npz,3001,14008,11007,10172,11155,983,7171,-2853,10024,0.3468161,0.33055055
GE.UGM.BH.gfz2010cvnw.npz,3001,6592,3591,4750,4816,66,1749,-1776,3525,0.33773798,0.32516348
GE.LUWI.SH.gfz2013fqap.npz,3001,1457,1544,4552,1425,3127,1551,-32,1583,0.41067928,0.34660393
GE.SANI.BL.gfz2013ykdd.npz,3001,11857,8856,11532,12250,718,8531,393,8138,0.38648224,0.3382613
GE.BKNI.SH.gfz2019ckqw.npz,3001,15095,12094,4922,15373,10451,1921,278,1643,0.37420252,0.33586574
GE.UGM.SH.gfz2014ojjv.npz,3000,3190,190,4895,5232,337,1895,2042,147,0.33999896,0.3247784
GE.TOLI2.SH.gfz2024vdim.npz,3000,3505,505,11193,3354,7839,8193,-151,8344,0.3371167,0.3251199
GE.TNTI.BL.gfz2017sglz.npz,3002,3540,538,4663,14492,9829,1661,10952,9291,0.36689812,0.33274004
GE.BNDI.BH.gfz2024urkq.npz,3001,1280,1721,8448,140,8308,5447,-1140,6587,0.33139718,0.3240704
GE.FAKI.BL.gfz2010gdlm.npz,3001,7963,4962,7888,8134,246,4887,171,4716,0.38441676,0.34046048
GE.FAKI.HH.gfz2009bjlo.npz,3000,264,2736,5960,770,5190,2960,506,2454,0.39050135,0.3333702
GE.LHMI.SH.gfz2010wlnb.npz,3000,5236,2236,5103,5304,201,2103,68,2035,0.3798314,0.33603418
GE.SANI.BH.gfz2013yfsc.npz,3001,11280,8279,10540,3265,7275,7539,-8015,15554,0.34890026,0.33261225
GE.SANI.SH.gfz2010occd.npz,3000,3470,470,7024,3346,3678,4024,-124,4148,0.38273764,0.3570165
GE.TNTI.BH.gfz2009fgfn.npz,3001,5,2996,6549,16996,10447,3548,16991,13443,0.346086,0.3210397
GE.LUWI.BH.gfz2012xqdd.npz,3001,3583,582,9250,10300,1050,6249,6717,468,0.34247223,0.32633346
GE.LUWI.BL.gfz2013fqap.npz,3001,4706,1705,4552,9802,5250,1551,5096,3545,0.35903043,0.33821613
GE.FAKI.SH.gfz2014ubqb.npz,3001,15402,12401,6766,15425,8659,3765,23,3742,0.45168594,0.3681338
GE.TOLI2.BH.gfz2024krts.npz,3001,3265,264,6470,3344,3126,3469,79,3390,0.35788375,0.32391217
GE.TNTI.SH.gfz2016mexu.npz,3000,4570,1570,3913,896,3017,913,-3674,4587,0.34433645,0.32712188
GE.FAKI.SH.gfz2009yode.npz,3001,3208,207,5932,3189,2743,2931,-19,2950,0.4227887,0.34595627
GE.TNTI.BL.gfz2012rrwm.npz,3000,6466,3466,5826,6092,266,2826,-374,3200,0.36483374,0.33530086
GE.SANI.BL.gfz2010awor.npz,3001,3242,241,7397,3134,4263,4396,-108,4504,0.38597995,0.3581932
GE.TOLI2.SH.gfz2018hbkr.npz,3001,3130,129,5160,3138,2022,2159,8,2151,0.36347806,0.33715636
GE.FAKI.HL.gfz2009bjnh.npz,3000,224,2776,6602,226,6376,3602,2,3600,0.45601308,0.36606142
GE.GENI.BH.gfz2018umjj.npz,3001,532,2469,4466,288,4178,1465,-244,1709,0.33849812,0.3252356
GE.UGM.BL.gfz2012lnpl.npz,3001,5384,2383,4805,5013,208,1804,-371,2175,0.35272422,0.33732367
GE.TNTI.BL.gfz2009floe.npz,3001,3304,303,7647,8475,828,4646,5171,525,0.36090672,0.3379726
GE.GENI.BL.gfz2012nver.npz,3001,1,3000,3966,4154,188,965,4153,3188,0.35128978,0.3318992
GE.SOEI.SH.gfz2018hode.npz,3001,824,2177,3731,938,2793,730,114,616,0.43371102,0.33770108
GE.UGM.HH.gfz2009ptvf.npz,3000,4994,1994,4987,3473,1514,1987,-1521,3508,0.3369285,0.32621136
GE.LUWI.BH.gfz2009ayxo.npz,3001,3632,631,8473,3021,5452,5472,-611,6083,0.33602077,0.32397196
GE.FAKI.BL.gfz2009brqi.npz,3001,3144,143,7069,7226,157,4068,4082,14,0.38035715,0.34651744
GE.MNAI.BH.gfz2010veze.npz,3001,4558,1557,4500,5177,677,1499,619,880,0.35321042,0.32922766
GE.MMRI.HL.gfz2009iayl.npz,3000,3976,976,8269,12794,4525,5269,8818,3549,0.5608786,0.38938543
GE.MNAI.SH.gfz2013mcso.npz,3001,5414,2413,5415,5402,13,2414,-12,2426,0.3712327,0.34448895
GE.GSI.BL.gfz2015bvov.npz,3001,4038,1037,3885,3619,266,884,-419,1303,0.34696212,0.32613793
GE.TNTI.HL.gfz2009qsnk.npz,3000,504,2496,7319,2178,5141,4319,1674,2645,0.54344946,0.39880982
GE.SOEI.BL.gfz2023jjmg.npz,3000,3312,312,8761,3507,5254,5761,195,5566,0.34789073,0.34164685
GE.BKB.SH.gfz2023qwer.npz,3001,1480,1521,10770,3963,6807,7769,2483,5286,0.33026832,0.3257604
GE.TNTI.SH.gfz2018lwgs.npz,3001,2305,696,7595,2753,4842,4594,448,4146,0.33311808,0.32466355
GE.SOEI.SH.gfz2013pyhb.npz,3000,344,2656,9330,6717,2613,6330,6373,43,0.3494431,0.3352287
GE.PLAI.BL.gfz2014esmj.npz,3001,2,2999,6214,5,6209,3213,3,3210,0.3695441,0.35667405
GE.JAGI.HH.gfz2009bbud.npz,3000,3678,678,8660,3946,4714,5660,268,5392,0.3559398,0.33547378
GE.TNTI.HH.gfz2009dseu.npz,3000,216,2784,6480,3,6477,3480,-213,3693,0.3566319,0.33486602
GE.TOLI2.BL.gfz2024cmtg.npz,3001,4377,1376,4168,4357,189,1167,-20,1187,0.38489127,0.33247733
GE.SANI.SH.gfz2023kcmg.npz,3000,10104,7104,9600,1,9599,6600,-10103,16703,0.33154157,0.32485127
GE.TOLI2.BH.gfz2025dygb.npz,3001,1240,1761,8049,5328,2721,5048,4088,960,0.33005488,0.3217552
GE.LUWI.BL.gfz2009qgjm.npz,3002,9242,6240,8471,9887,1416,5469,645,4824,0.34280878,0.33052525
GE.SOEI.HH.gfz2010kolf.npz,3000,8168,5168,9897,13460,3563,6897,5292,1605,0.531863,0.45803407
GE.LUWI.SH.gfz2024fyvc.npz,3000,1457,1543,6674,1455,5219,3674,-2,3676,0.3950152,0.3378308
GE.TNTI.HL.gfz2009bjnh.npz,3000,952,2048,9468,1659,7809,6468,707,5761,0.49707726,0.37576067
GE.BBJI.SH.gfz2024imhv.npz,3001,3895,894,13085,3890,9195,10084,-5,10089,0.33543807,0.32182842
GE.TNTI.BH.gfz2014hjch.npz,3001,4625,1624,4447,4685,238,1446,60,1386,0.33623073,0.3239933
GE.GSI.SH.gfz2010ncnk.npz,3000,5720,2720,5452,3552,1900,2452,-2168,4620,0.36370105,0.32943076
GE.SANI.SH.gfz2010antw.npz,3000,3264,264,7367,7701,334,4367,4437,70,0.39160565,0.34196487
GE.JAGI.BH.gfz2024wupd.npz,3000,3935,935,10181,11142,961,7181,7207,26,0.33534288,0.32478556
GE.TNTI.HL.gfz2012atdb.npz,3000,424,2576,7513,13330,5817,4513,12906,8393,0.5361932,0.3778893
GE.PLAI.BH.gfz2013vwga.npz,3001,3452,451,3381,3579,198,380,127,253,0.3572647,0.32656068
GE.TOLI2.SH.gfz2024stnc.npz,3000,3624,624,6049,3860,2189,3049,236,2813,0.33521923,0.32432285
GE.JAGI.BH.gfz2023gnmu.npz,3000,5350,2350,4953,5333,380,1953,-17,1970,0.36550236,0.34179974
GE.MMRI.SH.gfz2013ribh.npz,3000,4624,1624,4454,27,4427,1454,-4597,6051,0.35433096,0.33201578
GE.TNTI.BL.gfz2017ayqr.npz,3001,5192,2191,4346,4805,459,1345,-387,1732,0.35515803,0.3406205
GE.TOLI2.BH.gfz2024cmtg.npz,3001,4382,1381,4168,4303,135,1167,-79,1246,0.33885804,0.3318532
GE.SAUI.BH.gfz2013qvir.npz,3001,3238,237,6882,3187,3695,3881,-51,3932,0.34826675,0.32936448
GE.UGM.BH.gfz2009rejp.npz,3002,3398,396,6607,7823,1216,3605,4425,820,0.33881798,0.32210484
GE.SMRI.SH.gfz2012uneo.npz,3000,5224,2224,6917,5211,1706,3917,-13,3930,0.36088437,0.3404321
GE.TOLI2.BL.gfz2024vdim.npz,3001,3368,367,11194,14502,3308,8193,11134,2941,0.34563795,0.33127534
GE.JAGI.SH.gfz2018mwlr.npz,3001,5064,2063,4850,5142,292,1849,78,1771,0.37307754,0.33459908
GE.PLAI.BH.gfz2019qkjz.npz,3001,4610,1609,4497,3138,1359,1496,-1472,2968,0.3525601,0.32616103
GE.PLAI.BH.gfz2025amik.npz,3001,5197,2196,5068,5568,500,2067,371,1696,0.3416937,0.32503998
GE.MMRI.BH.gfz2025fwkg.npz,3002,4008,1006,12144,3672,8472,9142,-336,9478,0.3402268,0.33290327
GE.BNDI.BL.gfz2023dips.npz,3002,31,2971,6333,3222,3111,3331,3191,140,0.35107753,0.3320027
GE.MNAI.BL.gfz2018yajs.npz,3001,5390,2389,4976,5325,349,1975,-65,2040,0.3536174,0.33914348
GE.TOLI2.BH.gfz2017zisk.npz,3001,3933,932,3614,3864,250,613,-69,682,0.3467577,0.33422998
GE.SANI.BH.gfz2025ewvp.npz,3001,3345,344,10172,7207,2965,7171,3862,3309,0.33182177,0.32460627
GE.PLAI.BL.gfz2017ddhx.npz,3001,3175,174,6218,3181,3037,3217,6,3211,0.37343153,0.34553584
GE.UGM.SL.gfz2015vcni.npz,3000,584,2416,4541,576,3965,1541,-8,1549,0.4159656,0.34831986
GE.LUWI.BH.gfz2013ghxx.npz,3001,5140,2139,5045,3485,1560,2044,-1655,3699,0.34119838,0.32840705
GE.FAKI.BH.gfz2025dcky.npz,3001,8420,5419,8234,8750,516,5233,330,4903,0.3642021,0.33176947
GE.SMRI.BL.gfz2010ddjw.npz,3000,7393,4393,6484,3962,2522,3484,-3431,6915,0.35147592,0.32915398
GE.UGM.BL.gfz2009rejp.npz,3002,3390,388,6607,3621,2986,3605,231,3374,0.3500399,0.3296714
GE.UGM.BH.gfz2015vcni.npz,3001,4710,1709,4542,4704,162,1541,-6,1547,0.36575407,0.33780935
GE.FAKI.SH.gfz2010ghiq.npz,3000,3368,368,7380,3382,3998,4380,14,4366,0.43185917,0.3526204
GE.JAGI.SH.gfz2025bckw.npz,3000,3073,73,6921,3112,3809,3921,39,3882,0.34251374,0.3260401
GE.PLAI.SH.gfz2018hcmv.npz,3001,4619,1618,4252,4256,4,1251,-363,1614,0.35521132,0.32575172
GE.SANI.BL.gfz2024imhv.npz,3001,3284,283,7927,3943,3984,4926,659,4267,0.3522353,0.3332976
GE.SAUI.BL.gfz2009rpju.npz,3001,16850,13849,5302,6091,789,2301,-10759,13060,0.3483043,0.33674452
GE.TNTI.BL.gfz2009zjqg.npz,3001,3496,495,5763,6294,531,2762,2798,36,0.36853048,0.33305678
GE.FAKI.HL.gfz2009bjlo.npz,3000,260,2740,5960,15914,9954,2960,15654,12694,0.5007117,0.4162246
GE.TNTI.BH.gfz2011ywdf.npz,3001,3268,267,4745,3274,1471,1744,6,1738,0.34528235,0.34140137
GE.TNTI.BH.gfz2012yhuy.npz,3002,4040,1038,7569,4684,2885,4567,644,3923,0.3397097,0.3242591
GE.SANI.SH.gfz2022bkjt.npz,3000,8872,5872,8592,3,8589,5592,-8869,14461,0.34242538,0.3306324
GE.GSI.BL.gfz2021jpkx.npz,3001,3070,69,4984,16449,11465,1983,13379,11396,0.3591691,0.3290628
GE.BNDI.SH.gfz2024urkq.npz,3001,104,2897,8448,1521,6927,5447,1417,4030,0.35755572,0.34255216
GE.JAGI.BL.gfz2012rjhn.npz,3001,3128,127,5778,3161,2617,2777,33,2744,0.37742496,0.3431844
GE.UGM.BL.gfz2009npjw.npz,3001,6100,3099,5551,5932,381,2550,-168,2718,0.34567377,0.33773103
GE.UGM.BL.gfz2018iouz.npz,3001,3215,214,5081,3576,1505,2080,361,1719,0.34469277,0.32930884
GE.SANI.BL.gfz2022xote.npz,3001,7096,4095,6702,3309,3393,3701,-3787,7488,0.36318004,0.3486985
GE.SOEI.BH.gfz2025fshn.npz,3001,1,3000,8695,9863,1168,5694,9862,4168,0.3379721,0.32290053
GE.JAGI.BL.gfz2014esmj.npz,3001,3182,181,4598,5449,851,1597,2267,670,0.35946578,0.32875764
GE.TNTI.HH.gfz2009pyad.npz,3000,7,2993,7692,8907,1215,4692,8900,4208,0.34259102,0.32691205
GE.GSI.BH.gfz2010yvmm.npz,3001,6113,3112,5890,3062,2828,2889,-3051,5940,0.3650685,0.3551642
GE.BNDI.SH.gfz2021jacz.npz,3000,241,2759,4993,1029,3964,1993,788,1205,0.35327232,0.32699323
GE.JAGI.BH.gfz2012qetk.npz,3001,4327,1326,4295,4367,72,1294,40,1254,0.3654702,0.33793068
GE.TNTI.BL.gfz2009dctr.npz,3002,15485,12483,6920,874,6046,3918,-14611,18529,0.34249806,0.32896295
GE.BBJI.SH.gfz2024kkci.npz,3000,9266,6266,8116,3507,4609,5116,-5759,10875,0.33418468,0.3258225
GE.SAUI.BL.gfz2014brdi.npz,3001,3013,12,4658,5310,652,1657,2297,640,0.34157643,0.3317657
GE.LHMI.BH.gfz2016xzgq.npz,3001,4344,1343,4119,4319,200,1118,-25,1143,0.34501076,0.34461048
GE.LHMI.SH.gfz2013qpmq.npz,3000,3928,928,7921,3,7918,4921,-3925,8846,0.33729118,0.3292892
GE.PLAI.SH.gfz2012ilqg.npz,3000,3096,96,4887,3114,1773,1887,18,1869,0.37070784,0.3667878
GE.TOLI2.SH.gfz2013ghxx.npz,3000,3416,416,6552,4529,2023,3552,1113,2439,0.3486529,0.32610598
GE.TNTI.SH.gfz2014emyz.npz,3000,397,2603,8137,405,7732,5137,8,5129,0.34966648,0.33223647
GE.BNDI.BL.gfz2012xahl.npz,3001,5896,2895,5813,5901,88,2812,5,2807,0.36887848,0.33659086
GE.SOEI.BH.gfz2012amyi.npz,3001,3240,239,10378,7337,3041,7377,4097,3280,0.33460242,0.3229644
GE.SOEI.BH.gfz2010kolf.npz,3001,3329,328,9898,6949,2949,6897,3620,3277,0.33433303,0.3264937
GE.FAKI.SH.gfz2025dcky.npz,3001,8513,5512,8234,8475,241,5233,-38,5271,0.3805228,0.34893996
GE.JAGI.HL.gfz2009bkhv.npz,3000,1016,1984,5823,445,5378,2823,-571,3394,0.4979341,0.35879722
GE.MMRI.SH.gfz2025fwkg.npz,3001,485,2516,12143,10941,1202,9142,10456,1314,0.35859773,0.3359361
GE.JAGI.BH.gfz2009bbud.npz,3001,3638,637,8661,3498,5163,5660,-140,5800,0.35130033,0.3321166
GE.SOEI.BL.gfz2013tulg.npz,3002,3275,273,8351,3442,4909,5349,167,5182,0.34834093,0.34136233
GE.SOEI.HL.gfz2009psbv.npz,3000,328,2672,8427,15738,7311,5427,15410,9983,0.48037764,0.3866546
GE.FAKI.HH.gfz2009amcp.npz,3000,788,2212,6069,880,5189,3069,92,2977,0.33868843,0.32548228
GE.SAUI.BL.gfz2012rbpj.npz,3001,6375,3374,5751,4619,1132,2750,-1756,4506,0.34360293,0.33282036
GE.JAGI.BL.gfz2013jndg.npz,3001,7318,4317,6825,113,6712,3824,-7205,11029,0.36134675,0.3315106
GE.MMRI.BL.gfz2009ilut.npz,3002,822,2180,9477,5152,4325,6475,4330,2145,0.34894955,0.33382425
GE.TNTI.HH.gfz2009floe.npz,3000,3308,308,7646,3108,4538,4646,-200,4846,0.3520864,0.3313559
GE.BBJI.SH.gfz2024tufl.npz,3001,3309,308,6501,4033,2468,3500,724,2776,0.33545834,0.32356256
GE.PLAI.SH.gfz2018pmjk.npz,3001,5720,2719,5199,5637,438,2198,-83,2281,0.32973185,0.32194257
GE.PLAI.BH.gfz2023sjso.npz,3001,4520,1519,4414,4518,104,1413,-2,1415,0.3582692,0.3254506
GE.UGM.BL.gfz2013ttpe.npz,3000,3332,332,4938,5306,368,1938,1974,36,0.35724154,0.34510398
GE.SMRI.BH.gfz2013qeoy.npz,3001,6438,3437,5994,3758,2236,2993,-2680,5673,0.33846354,0.3247476
GE.UGM.BL.gfz2012kaia.npz,3001,4420,1419,4409,4593,184,1408,173,1235,0.3629449,0.3385209
GE.BNDI.BL.gfz2023jjmg.npz,3002,3797,795,11087,242,10845,8085,-3555,11640,0.35093516,0.33505294
GE.FAKI.SH.gfz2014genx.npz,3001,1,3000,6226,400,5826,3225,399,2826,0.34460577,0.32468203
GE.LUWI.BL.gfz2009boun.npz,3002,4404,1402,4399,4762,363,1397,358,1039,0.39667833,0.34483182
GE.TNTI.SH.gfz2014fzbl.npz,3000,1350,1650,4712,1120,3592,1712,-230,1942,0.3367932,0.3240693
GE.FAKI.SH.gfz2011ycjg.npz,3000,10256,7256,9819,3760,6059,6819,-6496,13315,0.34178147,0.3254958
GE.TNTI.SH.gfz2013udpf.npz,3001,13544,10543,4565,5083,518,1564,-8461,10025,0.3434958,0.3310369
GE.LUWI.BL.gfz2011xxju.npz,3001,3684,683,8322,8827,505,5321,5143,178,0.35787857,0.33599603
GE.LUWI.BH.gfz2009itjx.npz,3001,15448,12447,8637,14220,5583,5636,-1228,6864,0.34993967,0.32976976
GE.SANI.BH.gfz2024hgro.npz,3001,4038,1037,7988,3437,4551,4987,-601,5588,0.33550984,0.33327997
GE.SANI.SH.gfz2011xxju.npz,3001,5516,2515,5398,3117,2281,2397,-2399,4796,0.41194144,0.37733492
GE.GSI.BL.gfz2010ncnk.npz,3001,5651,2650,5453,3070,2383,2452,-2581,5033,0.35950688,0.34292474
GE.UGM.SH.gfz2011yfab.npz,3001,3745,744,6670,7561,891,3669,3816,147,0.3440802,0.3260993
GE.SANI.SH.gfz2013ucyl.npz,3001,13176,10175,9919,12603,2684,6918,-573,7491,0.3528988,0.33124867
GE.GSI.BH.gfz2009dygp.npz,3001,4232,1231,3913,592,3321,912,-3640,4552,0.34616265,0.3244838
GE.TNTI.BL.gfz2009eqqh.npz,3001,4594,1593,4182,13996,9814,1181,9402,8221,0.3533907,0.33101445
GE.SAUI.BH.gfz2014brdi.npz,3001,5031,2030,4658,3027,1631,1657,-2004,3661,0.33588412,0.33092144
GE.PLAI.BH.gfz2025bmwa.npz,3001,5302,2301,5233,5421,188,2232,119,2113,0.3455089,0.32691023
GE.TNTI.SH.gfz2019sgac.npz,3001,478,2523,5309,15329,10020,2308,14851,12543,0.3542127,0.32966483
GE.SOEI.BH.gfz2009psbv.npz,3001,4208,1207,8428,3740,4688,5427,-468,5895,0.33962515,0.3287876
GE.MNAI.BL.gfz2009qkfw.npz,3001,6678,3677,5857,200,5657,2856,-6478,9334,0.35203788,0.33163217
GE.JAGI.BH.gfz2009bkhv.npz,3001,3205,204,5824,6270,446,2823,3065,242,0.34053084,0.33645284
GE.MNAI.BL.gfz2013goiq.npz,3001,4093,1092,4036,1249,2787,1035,-2844,3879,0.40458262,0.3413654
GE.MMRI.BH.gfz2009pxvj.npz,3001,3478,477,8395,7310,1085,5394,3832,1562,0.33254156,0.32135686
GE.UGM.BH.gfz2018hcuv.npz,3001,5171,2170,4590,3195,1395,1589,-1976,3565,0.34419358,0.32973057
GE.TNTI.HL.gfz2009eavu.npz,3000,15128,12128,8071,15403,7332,5071,275,4796,0.52347064,0.37928522
GE.FAKI.BL.gfz2009apup.npz,3002,6060,3058,5920,3106,2814,2918,-2954,5872,0.35540968,0.33607152
GE.LUWI.BL.gfz2013pxfu.npz,3001,4923,1922,4833,4969,136,1832,46,1786,0.3817386,0.3335125
GE.MNAI.BH.gfz2021lyjz.npz,3001,3,2998,3840,3879,39,839,3876,3037,0.4179966,0.3343466
GE.PLAI.SL.gfz2012azkx.npz,3000,3120,120,4447,15493,11046,1447,12373,10926,0.45250028,0.3366758
GE.LUWI.HL.gfz2009bjnh.npz,3000,2264,736,11852,622,11230,8852,-1642,10494,0.7422967,0.3916052
GE.LHMI.BL.gfz2023acqq.npz,3001,15384,12383,3337,15330,11993,336,-54,390,0.36999333,0.33441168
GE.BNDI.BL.gfz2010abkc.npz,3001,7080,4079,6066,8362,2296,3065,1282,1783,0.34664664,0.33070514
GE.SOEI.BH.gfz2025bzud.npz,3001,3333,332,9172,3292,5880,6171,-41,6212,0.3417588,0.33027554
GE.TNTI.SH.gfz2023szzv.npz,3001,296,2705,6972,4509,2463,3971,4213,242,0.37117624,0.32661906
GE.TNTI.BH.gfz2025czgt.npz,3001,4667,1666,4240,779,3461,1239,-3888,5127,0.34026405,0.3290013
GE.TNTI.BL.gfz2012yhuy.npz,3002,4072,1070,7569,4653,2916,4567,581,3986,0.33998924,0.32962978
GE.TNTI.BH.gfz2009dhbx.npz,3000,4420,1420,6534,3436,3098,3534,-984,4518,0.3343854,0.3242948
GE.TNTI.BH.gfz2009pyad.npz,3001,8260,5259,7693,13452,5759,4692,5192,500,0.34027737,0.324515
GE.JAGI.SH.gfz2014ghxq.npz,3000,16536,13536,4668,4842,174,1668,-11694,13362,0.3990471,0.34480497
GE.SOEI.BH.gfz2009zbqz.npz,3001,3432,431,9906,5698,4208,6905,2266,4639,0.33372706,0.32229772
GE.LUWI.SH.gfz2024fmvg.npz,3001,39,2962,7831,45,7786,4830,6,4824,0.35465473,0.33001205
GE.TNTI.BH.gfz2015thvg.npz,3001,6552,3551,5645,6367,722,2644,-185,2829,0.34600955,0.327452
GE.TOLI2.BH.gfz2025dlfh.npz,3001,5497,2496,5085,5144,59,2084,-353,2437,0.34193137,0.3346857
GE.GSI.BL.gfz2010yvmm.npz,3001,3060,59,5890,3054,2836,2889,-6,2895,0.4200486,0.3675798
