filename,p_true,p_pred,p_error,s_true,s_pred,s_error,ps_true,ps_pred,ps_error,p_prob_max,s_prob_max
GE.UGM.BL.gfz2010ddjw.npz,3001,6112,3111,5719,6035,316,2718,-77,2795,0.99386334,0.99978656
GE.TNTI.BL.gfz2009ayha.npz,3000,12080,9080,9659,5199,4460,6659,-6881,13540,0.93492085,0.9781617
GE.SOEI.BH.gfz2012mpmh.npz,3001,8016,5015,6999,15074,8075,3998,7058,3060,0.9993106,0.99976844
GE.MNAI.BL.gfz2009xyqn.npz,3001,4112,1111,4086,4196,110,1085,84,1001,0.99619967,0.99931157
GE.LHMI.SH.gfz2013urpd.npz,3001,7904,4903,4666,7891,3225,1665,-13,1678,0.9996915,0.9999913
GE.PLAI.SL.gfz2012xqdd.npz,3000,7856,4856,7549,7906,357,4549,50,4499,0.9996178,0.99976915
GE.MMRI.SH.gfz2013hbue.npz,3000,1200,1800,6667,7123,456,3667,5923,2256,0.99225026,0.99913174
GE.BNDI.SH.gfz2018qhyw.npz,3000,11536,8536,4533,4883,350,1533,-6653,8186,0.9822519,0.9976519
GE.TNTI.BL.gfz2009fgfn.npz,3001,8,2993,6549,1299,5250,3548,1291,2257,0.99554646,0.9978315
GE.MMRI.BL.gfz2019hinv.npz,3001,3050,49,5213,3283,1930,2212,233,1979,0.9815176,0.992293
GE.FAKI.BH.gfz2009ayxo.npz,3001,368,2633,8473,339,8134,5472,-29,5501,0.9997856,0.99998593
GE.SOEI.BL.gfz2013yfql.npz,3001,688,2313,3736,595,3141,735,-93,828,0.99945337,0.9999819
GE.GSI.BH.gfz2012uhbt.npz,3001,4832,1831,4276,4751,475,1275,-81,1356,0.98932344,0.9983286
GE.LHMI.BL.gfz2012rato.npz,3001,16528,13527,4813,4898,85,1812,-11630,13442,0.98611325,0.9966793
GE.LUWI.HH.gfz2009qkjn.npz,3000,816,2184,5035,787,4248,2035,-29,2064,0.9945933,0.9997416
GE.PLAI.SH.gfz2024yqam.npz,3001,40,2961,6897,7059,162,3896,7019,3123,0.9953081,0.99896836
GE.GSI.BL.gfz2021kfyy.npz,3001,5584,2583,5467,5583,116,2466,-1,-1,0.9997205,0.99886477
GE.MMRI.SH.gfz2024wupd.npz,3001,3040,39,7869,7955,86,4868,4915,47,0.99538535,0.9983713
GE.PLAI.SL.gfz2017ddhx.npz,3000,6448,3448,6217,6547,330,3217,99,3118,0.99276924,0.9974739
GE.BBJI.BH.gfz2024nomt.npz,3001,15248,12247,5838,15251,9413,2837,3,2834,0.9925569,0.9988973
GE.LUWI.SH.gfz2010abbl.npz,3001,1728,1273,8712,1683,7029,5711,-45,5756,0.9882384,0.99929905
GE.JAGI.SH.gfz2012qetk.npz,3001,4368,1367,4295,4386,91,1294,18,1276,0.9995184,0.9997502
GE.LUWI.BL.gfz2010ciep.npz,3001,4576,1575,4317,4691,374,1316,115,1201,0.9974452,0.99949944
GE.FAKI.BH.gfz2012amyi.npz,3001,8288,5287,7987,8275,288,4986,-13,4999,0.99407405,0.9981945
GE.BNDI.BH.gfz2012gezz.npz,3001,14960,11959,4821,14931,10110,1820,-29,1849,0.9950117,0.99956244
GE.JAGI.SH.gfz2013hbue.npz,3001,8,2993,8466,915,7551,5465,907,4558,0.9997838,0.99985063
GE.GSI.SH.gfz2015bvov.npz,3000,15472,12472,3884,15443,11559,884,-29,913,0.9975936,0.999866
GE.SAUI.BH.gfz2020iiaf.npz,3001,15296,12295,4910,15251,10341,1909,-45,1954,0.9977456,0.99931896
GE.JAGI.BH.gfz2017nmdx.npz,3001,4752,1751,4595,4770,175,1594,18,1576,0.9979323,0.9987411
GE.FAKI.HL.gfz2009bmox.npz,3000,1248,1752,9002,1122,7880,6002,-126,6128,0.96731555,0.9894537
GE.GSI.BH.gfz2013qpmq.npz,3001,11280,8279,5213,13587,8374,2212,2307,95,0.99783117,0.9997254
GE.SOEI.BH.gfz2009rpju.npz,3001,3856,855,10619,851,9768,7618,-3005,10623,0.9996202,0.99983346
GE.FAKI.BL.gfz2009daap.npz,3001,432,2569,8275,435,7840,5274,3,5271,0.9998473,0.99999106
GE.LUWI.HL.gfz2009ilut.npz,3000,11280,8280,11427,11298,129,8427,18,8409,0.9961222,0.9989812
GE.FAKI.BH.gfz2009yode.npz,3001,6112,3111,5932,6114,182,2931,2,2929,0.99707866,0.9998716
GE.FAKI.BL.gfz2013wlbf.npz,3001,5040,2039,5560,4947,613,2559,-93,2652,0.9939383,0.99915195
GE.TNTI.HL.gfz2009rdgk.npz,3000,14320,11320,5206,14291,9085,2206,-29,2235,0.9932116,0.9961144
GE.MMRI.BH.gfz2025amik.npz,3001,4880,1879,6520,5011,1509,3519,131,3388,0.9993376,0.9995241
GE.SAUI.HH.gfz2009tkfn.npz,3000,12624,9624,11707,12115,408,8707,-509,9216,0.99781185,0.9998337
GE.TNTI.BL.gfz2009bmox.npz,3002,5472,2470,5029,5459,430,2027,-13,2040,0.97620165,0.99435884
GE.LUWI.BL.gfz2009bjnh.npz,3001,12304,9303,11853,11731,122,8852,-573,9425,0.9882252,0.99718237
GE.MMRI.BL.gfz2012ugap.npz,3001,5680,2679,5375,5843,468,2374,163,2211,0.97894007,0.995815
GE.FAKI.BL.gfz2009aqpt.npz,3001,3152,151,6401,16211,9810,3400,13059,9659,0.9998381,0.9994118
GE.TNTI.BL.gfz2009czsb.npz,3001,3802,801,6556,3795,2761,3555,-7,3562,0.9818017,0.99554294
GE.TNTI.SH.gfz2012yhuy.npz,3000,7696,4696,7567,15187,7620,4567,7491,2924,0.99768245,0.9979219
GE.UGM.SL.gfz2014bxsc.npz,3001,4848,1847,4752,4883,131,1751,35,1716,0.9956567,0.99971765
GE.SOEI.SH.gfz2013qvir.npz,3000,9008,6008,8059,8979,920,5059,-29,5088,0.99748445,0.9995407
GE.UGM.SH.gfz2012uneo.npz,3000,8176,5176,6797,9875,3078,3797,1699,2098,0.9948784,0.9988293
GE.JAGI.BH.gfz2024xkub.npz,3001,15728,12727,4170,15699,11529,1169,-29,1198,0.9855215,0.9982651
GE.TOLI2.SH.gfz2013hjin.npz,3001,15248,12247,10615,15187,4572,7614,-61,7675,0.9970061,0.99977976
GE.MMRI.HH.gfz2009ilut.npz,3000,9560,6560,9475,9555,80,6475,-5,6480,0.9960557,0.9997794
GE.LUWI.BL.gfz2012wmnj.npz,3001,5280,2279,4934,5139,205,1933,-141,2074,0.98476505,0.9986939
GE.FAKI.HH.gfz2009atqt.npz,3000,14960,11960,6303,14931,8628,3303,-29,3332,0.9977375,0.9998437
GE.BKNI.SH.gfz2022gjiw.npz,3001,6416,3415,6140,6419,279,3139,3,3136,0.9953241,0.99892837
GE.TNTI.BH.gfz2009frwm.npz,3001,14672,11671,6454,14692,8238,3453,20,3433,0.986091,0.9953786
GE.FAKI.BH.gfz2009rpju.npz,3001,7536,4535,7454,7609,155,4453,73,4380,0.9982816,0.9995321
GE.SMRI.SH.gfz2015vcni.npz,3001,7312,4311,5258,11731,6473,2257,4419,2162,0.9991021,0.99990153
GE.SAUI.BL.gfz2010kolf.npz,3001,3024,23,5503,467,5036,2502,-2557,5059,0.9961448,0.9935588
GE.UGM.SH.gfz2012atnm.npz,3001,13712,10711,4416,13715,9299,1415,3,1412,0.99858826,0.99966323
GE.PLAI.BH.gfz2019cznc.npz,3001,336,2665,4364,275,4089,1363,-61,1424,0.999213,0.99983656
GE.TNTI.BH.gfz2013rzij.npz,3001,3216,215,4609,14931,10322,1608,11715,10107,0.9902536,0.99587613
GE.SAUI.HH.gfz2009sufe.npz,3000,14480,11480,5196,12883,7687,2196,-1597,3793,0.99034286,0.99921393
GE.FAKI.HL.gfz2009bgxf.npz,3000,3248,248,5890,8339,2449,2890,5091,2201,0.97782826,0.9961898
GE.SAUI.SH.gfz2021ubnw.npz,3000,15120,12120,4858,5395,537,1858,-9725,11583,0.99783164,0.99955004
GE.TNTI.BL.gfz2013rzij.npz,3001,14896,11895,4609,3343,1266,1608,-11553,13161,0.9637955,0.9893817
GE.UGM.SH.gfz2010fnia.npz,3000,15760,12760,4764,15747,10983,1764,-13,1777,0.99988663,0.99995685
GE.SMRI.BH.gfz2013jvgk.npz,3001,1232,1769,7004,1747,5257,4003,515,3488,0.999729,0.99997973
GE.SMRI.BH.gfz2009boyf.npz,3002,12848,9846,6155,12819,6664,3153,-29,3182,0.99869126,0.9999472
GE.LHMI.BL.gfz2013urpd.npz,3001,8912,5911,4666,4831,165,1665,-4081,5746,0.9919813,0.9978695
GE.MNAI.BH.gfz2010atkp.npz,3001,4176,1175,4187,787,3400,1186,-3389,4575,0.9919858,0.9988661
GE.FAKI.HH.gfz2009dkli.npz,3000,8480,5480,12495,8467,4028,9495,-13,9508,0.99897456,0.9999523
GE.TNTI.HH.gfz2009qghs.npz,3000,9864,6864,5191,9843,4652,2191,-21,2212,0.98270607,0.997244
GE.MMRI.BH.gfz2013fkbz.npz,3002,912,2090,5505,851,4654,2503,-61,2564,0.98858565,0.998251
GE.TNTI.BH.gfz2010awor.npz,3001,7760,4759,7411,7778,367,4410,18,4392,0.9979808,0.9995492
GE.TNTI.HL.gfz2009bmox.npz,3000,5600,2600,5027,5459,432,2027,-141,2168,0.96635914,0.9929657
GE.MMRI.BH.gfz2024wupd.npz,3002,3040,38,7870,7955,85,4868,4915,47,0.9973641,0.99859554
GE.UGM.BH.gfz2009ptvf.npz,3001,14864,11863,4988,531,4457,1987,-14333,16320,0.9978992,0.9997181
GE.TOLI2.SH.gfz2012yhuy.npz,3000,1872,1128,11977,1811,10166,8977,-61,9038,0.99905235,0.9999378
GE.FAKI.BL.gfz2009avte.npz,3000,8544,5544,8234,8420,186,5234,-124,5358,0.9979182,0.9997718
GE.LUWI.HL.gfz2009floe.npz,3000,6304,3304,6111,403,5708,3111,-5901,9012,0.9935534,0.9994326
GE.JAGI.BL.gfz2012rjfs.npz,3002,15056,12054,5948,6803,855,2946,-8253,11199,0.9741683,0.99055874
GE.SOEI.BH.gfz2012heuj.npz,3001,7248,4247,9064,7187,1877,6063,-61,6124,0.99989355,0.9999881
GE.TNTI.BH.gfz2024qrxn.npz,3001,8,2993,4820,211,4609,1819,203,1616,0.99612564,0.9984457
GE.SANI.SH.gfz2015thvg.npz,3000,3120,120,6552,3170,3382,3552,50,3502,0.998357,0.99979335
GE.TNTI.BH.gfz2009dseu.npz,3001,8,2993,6481,7251,770,3480,7243,3763,0.9968719,0.99834013
GE.LUWI.SH.gfz2017cdvt.npz,3001,4656,1655,4261,4514,253,1260,-142,1402,0.9920884,0.9988834
GE.GSI.SH.gfz2010wlnb.npz,3000,16032,13032,5862,15891,10029,2862,-141,3003,0.9987293,0.999936
GE.MNAI.BL.gfz2013ydaj.npz,3000,5096,2096,4816,5092,276,1816,-4,1820,0.9815165,0.99560636
GE.GENI.SH.gfz2012nver.npz,3000,12624,9624,3965,4063,98,965,-8561,9526,0.99554354,0.9994241
GE.LUWI.BH.gfz2009bjnh.npz,3001,13712,10711,11853,13459,1606,8852,-253,9105,0.9988171,0.99940753
GE.UGM.BH.gfz2016dbtc.npz,3001,14224,11223,5389,12307,6918,2388,-1917,4305,0.997267,0.99955684
GE.TOLI2.SH.gfz2025dlfh.npz,3000,976,2024,5084,979,4105,2084,3,2081,0.9988507,0.9999138
GE.UGM.BH.gfz2010fnia.npz,3001,15760,12759,4765,15763,10998,1764,3,1761,0.9998729,0.9999567
GE.TOLI2.BL.gfz2025bymb.npz,3001,4656,1655,4214,4578,364,1213,-78,1291,0.991979,0.99686
GE.PLAI.BL.gfz2012dcye.npz,3001,416,2585,4107,403,3704,1106,-13,1119,0.9988594,0.99989617
GE.FAKI.HL.gfz2009tkfn.npz,3000,6576,3576,6328,6547,219,3328,-29,3357,0.99960977,0.9999019
GE.SOEI.HH.gfz2009qfbt.npz,3000,1808,1192,8523,1683,6840,5523,-125,5648,0.9994925,0.99996805
GE.FAKI.SH.gfz2009zbqz.npz,3000,8240,5240,8099,3283,4816,5099,-4957,10056,0.99841285,0.9991714
GE.PLAI.BL.gfz2014ghxq.npz,3001,6432,3431,5977,3347,2630,2976,-3085,6061,0.98608685,0.9972676
GE.TOLI2.BH.gfz2024qmwb.npz,3001,8,2993,11311,1427,9884,8310,1419,6891,0.999358,0.9986601
GE.PLAI.BH.gfz2025bckw.npz,3001,4736,1735,4563,4735,172,1562,-1,-1,0.9972568,0.99945456
GE.MNAI.BH.gfz2013xmza.npz,3001,848,2153,4007,851,3156,1006,3,1003,0.99980634,0.99994075
GE.MNAI.HL.gfz2009rjtx.npz,3000,8552,5552,8202,8579,377,5202,27,5175,0.99148667,0.99897707
GE.GSI.SH.gfz2013cxen.npz,3000,992,2008,5901,787,5114,2901,-205,3106,0.99718565,0.9995931
GE.UGM.BL.gfz2013crnj.npz,3001,4688,1687,4648,723,3925,1647,-3965,5612,0.9981346,0.99968314
GE.UGM.SL.gfz2013ttpe.npz,3000,15856,12856,4938,5154,216,1938,-10702,12640,0.9916637,0.9969119
GE.FAKI.BH.gfz2009aixg.npz,3001,15312,12311,6068,12243,6175,3067,-3069,6136,0.9980404,0.99985003
GE.FAKI.BL.gfz2009zbqz.npz,3001,8232,5231,8100,3283,4817,5099,-4949,10048,0.9961265,0.99942493
GE.FAKI.BL.gfz2012cnkn.npz,3001,6704,3703,6386,6543,157,3385,-161,3546,0.9940667,0.9990382
GE.GSI.SH.gfz2021kfyy.npz,3000,1296,1704,5466,1171,4295,2466,-125,2591,0.99904925,0.9999385
GE.SMRI.HL.gfz2009boyf.npz,3000,16704,13704,6153,16697,10544,3153,-7,3160,0.9980046,0.99856037
GE.TNTI.HL.gfz2009agwc.npz,3000,8672,5672,8357,8595,238,5357,-77,5434,0.9873453,0.9994831
GE.BKNI.BH.gfz2012gitd.npz,3001,4464,1463,4376,4514,138,1375,50,1325,0.998454,0.9992624
GE.SOEI.BL.gfz2025gvra.npz,3001,4080,1079,9939,3987,5952,6938,-93,7031,0.99775,0.99911886
GE.LHMI.BL.gfz2011kyss.npz,3000,5616,2616,4774,5619,845,1774,3,1771,0.9836167,0.99745923
GE.TNTI.BH.gfz2009hmmo.npz,3002,3018,16,5880,3411,2469,2878,393,2485,0.99587977,0.99897337
GE.FAKI.HL.gfz2009ewtf.npz,3000,1584,1416,10975,1572,9403,7975,-12,7987,0.98487955,0.9962095
GE.FAKI.HH.gfz2009ayty.npz,3000,1168,1832,6316,1107,5209,3316,-61,3377,0.9944871,0.9992654
GE.UGM.BL.gfz2009bbud.npz,3001,5528,2527,5427,5523,96,2426,-5,2431,0.9964217,0.9998037
GE.UGM.SH.gfz2014kwfg.npz,3001,4720,1719,4692,4755,63,1691,35,1656,0.9993006,0.9999409
GE.SAUI.BL.gfz2013tulg.npz,3001,7456,4455,6696,7458,762,3695,2,3693,0.9755047,0.9923315
GE.UGM.BH.gfz2009bjnh.npz,3000,10640,7640,13085,9107,3978,10085,-1533,11618,0.9977604,0.9995252
GE.SANI.BH.gfz2011xxju.npz,3001,3056,55,5398,5459,61,2397,2403,6,0.9969675,0.99963665
GE.FAKI.HL.gfz2009nqxv.npz,3000,8032,5032,7630,7906,276,4630,-126,4756,0.9888502,0.99872977
GE.PLAI.SH.gfz2017culr.npz,3001,4496,1495,4408,4563,155,1407,67,1340,0.99995995,0.9998029
GE.LUWI.BH.gfz2009floe.npz,3001,6384,3383,6112,6355,243,3111,-29,3140,0.9916751,0.99898475
GE.SANI.SH.gfz2013grue.npz,3000,3696,696,11086,3603,7483,8086,-93,8179,0.99094933,0.9986523
GE.FAKI.BL.gfz2009cdlz.npz,3001,224,2777,7166,195,6971,4165,-29,4194,0.99915445,0.99988437
GE.MMRI.BH.gfz2013ribh.npz,3001,5968,2967,4455,787,3668,1454,-5181,6635,0.99425006,0.99799335
GE.LHMI.HL.gfz2009epev.npz,3000,4720,1720,4127,4722,595,1127,2,1125,0.99699736,0.99965787
GE.TNTI.BL.gfz2009qgjm.npz,3001,5040,2039,4572,4962,390,1571,-78,1649,0.9795334,0.9920729
GE.MMRI.BL.gfz2013hbue.npz,3001,224,2777,6668,243,6425,3667,19,3648,0.9961494,0.9989926
GE.JAGI.BL.gfz2009zipp.npz,3001,15968,12967,7122,15970,8848,4121,2,4119,0.98443145,0.99761236
GE.BNDI.BL.gfz2017bxmp.npz,3001,5864,2863,5531,5858,327,2530,-6,2536,0.9810619,0.99575436
GE.GSI.BH.gfz2022twah.npz,3001,4592,1591,3922,4435,513,921,-157,1078,0.9958994,0.99981767
GE.MMRI.BH.gfz2022sqkl.npz,3001,4176,1175,6512,6867,355,3511,2691,820,0.9861731,0.99632615
GE.TNTI.HH.gfz2009agwc.npz,3000,3146,146,8357,8531,174,5357,5385,28,0.99294335,0.999671
GE.MNAI.SH.gfz2021lyjz.npz,3001,15072,12071,3840,15059,11219,839,-13,852,0.9843572,0.99595034
GE.FAKI.HL.gfz2009aczt.npz,3000,14832,11832,13085,14867,1782,10085,35,10050,0.99528,0.99894565
GE.FAKI.BH.gfz2010kolf.npz,3000,288,2712,8220,275,7945,5220,-13,5233,0.998855,0.9999294
GE.LUWI.SH.gfz2024hdte.npz,3001,12496,9495,10475,16083,5608,7474,3587,3887,0.9795359,0.99714774
GE.SOEI.HH.gfz2009rpju.npz,3000,3856,856,10618,851,9767,7618,-3005,10623,0.9996666,0.9998325
GE.PLAI.BH.gfz2014esmj.npz,3001,752,2249,6214,787,5427,3213,35,3178,0.9990299,0.9998074
GE.PLAI.SH.gfz2022sqkl.npz,3001,5152,2151,5093,5139,46,2092,-13,2105,0.999846,0.99972385
GE.FAKI.BL.gfz2009ayty.npz,3000,6496,3496,6316,6483,167,3316,-13,3329,0.9929234,0.9991085
GE.PMBI.BL.gfz2011swwe.npz,3000,15472,12472,5673,5651,22,2673,-9821,12494,0.9854859,0.99348783
GE.UGM.BL.gfz2010bjpa.npz,3001,7472,4471,6717,7161,444,3716,-311,4027,0.9951025,0.9988225
GE.TNTI.HH.gfz2009algf.npz,3000,3338,338,4726,15283,10557,1726,11945,10219,0.99726343,0.9991549
GE.TNTI.BH.gfz2020iwiv.npz,3001,5280,2279,4420,8787,4367,1419,3507,2088,0.99059653,0.99845517
GE.TNTI.SH.gfz2014hjch.npz,3001,4432,1431,4447,4706,259,1446,274,1172,0.99676657,0.99814916
GE.LUWI.BL.gfz2012rszr.npz,3001,6624,3623,6320,6690,370,3319,66,3253,0.99821174,0.99962616
GE.GSI.BH.gfz2022gjiw.npz,3000,3018,18,5410,3091,2319,2410,73,2337,0.9940376,0.99913424
GE.TOLI2.SH.gfz2025bymb.npz,3001,2,2999,4214,4659,445,1213,4657,3444,0.9999515,0.9995869
GE.SOEI.BL.gfz2025dcky.npz,3000,10096,7096,9361,10707,1346,6361,611,5750,0.99650025,0.99868196
GE.TNTI.BH.gfz2017ayqr.npz,3001,11504,8503,4346,11475,7129,1345,-29,1374,0.9887367,0.9978815
GE.TNTI.SH.gfz2014jcyq.npz,3000,3018,18,7235,7714,479,4235,4696,461,0.99524164,0.99819046
GE.SAUI.SH.gfz2013aruy.npz,3000,12944,9944,5769,723,5046,2769,-12221,14990,0.99910456,0.9994874
GE.TNTI.BH.gfz2009czsb.npz,3001,4240,1239,6556,4243,2313,3555,3,3552,0.9981249,0.9998012
GE.PLAI.BH.gfz2019usec.npz,3001,4250,1249,4222,4243,21,1221,-7,1228,0.999949,0.99986696
GE.GSI.BH.gfz2009cktz.npz,3001,16040,13039,5152,16019,10867,2151,-21,2172,0.9985985,0.9999522
GE.MNAI.HL.gfz2009mwyd.npz,3000,5936,2936,5775,5967,192,2775,31,2744,0.9688598,0.9943885
GE.FAKI.BL.gfz2009agmj.npz,3001,15056,12055,6180,15043,8863,3179,-13,3192,0.99768806,0.999483
GE.FAKI.SH.gfz2014fbzr.npz,3000,16208,13208,5986,16275,10289,2986,67,2919,0.9910635,0.99869424
GE.UGM.BL.gfz2012uneo.npz,3002,7472,4470,6799,7443,644,3797,-29,3826,0.99177104,0.99656564
GE.SAUI.BH.gfz2016mcqf.npz,3001,13928,10927,5266,14611,9345,2265,683,1582,0.9895056,0.9990276
GE.MMRI.BH.gfz2009efga.npz,3001,2896,105,9775,5907,3868,6774,3011,3763,0.9947076,0.9991768
GE.BBJI.BL.gfz2018bubc.npz,3001,4976,1975,4926,5011,85,1925,35,1890,0.99989533,0.999987
GE.PLAI.BL.gfz2013sril.npz,3001,6144,3143,5556,6035,479,2555,-109,2664,0.98309463,0.9981799
GE.SANI.BH.gfz2013nflx.npz,3001,240,2761,8963,211,8752,5962,-29,5991,0.99992156,0.99999475
GE.PLAI.SH.gfz2025bmwa.npz,3001,1424,1577,5233,1363,3870,2232,-61,2293,0.99776506,0.99975723
GE.MMRI.BH.gfz2009ilut.npz,3002,9576,6574,9477,9555,78,6475,-21,6496,0.9971994,0.999828
GE.GSI.BL.gfz2016rfim.npz,3001,14256,11255,4568,14227,9659,1567,-29,1596,0.99255884,0.99604464
GE.BBJI.BH.gfz2024xqwc.npz,3001,1136,1865,4051,1107,2944,1050,-29,1079,0.9985525,0.99993324
GE.TNTI.HL.gfz2009waho.npz,3000,6120,3120,5791,6114,323,2791,-6,2797,0.9814445,0.9966822
GE.TNTI.BH.gfz2009eqqh.npz,3001,4426,1425,4182,16147,11965,1181,11721,10540,0.98343545,0.9976872
GE.JAGI.BH.gfz2009ruvn.npz,3001,4752,1751,7304,4755,2549,4303,3,4300,0.9961461,0.99962485
GE.JAGI.HH.gfz2009bkhv.npz,3000,208,2792,5823,211,5612,2823,3,2820,0.99684745,0.99937254
GE.TNTI.BH.gfz2024fmvg.npz,3002,5024,2022,4405,5011,606,1403,-13,1416,0.9910261,0.9971021
GE.SAUI.BL.gfz2020iiaf.npz,3001,3130,129,4910,5523,613,1909,2393,484,0.98759604,0.9987973
GE.PLAI.SL.gfz2019qkjz.npz,3000,4560,1560,4496,4687,191,1496,127,1369,0.98969954,0.99860185
GE.BNDI.SH.gfz2009yode.npz,3001,5856,2855,5360,13971,8611,2359,8115,5756,0.9900405,0.99868923
GE.UGM.BH.gfz2010teou.npz,3001,13392,10391,7812,13331,5519,4811,-61,4872,0.99744296,0.99853706
GE.SAUI.BL.gfz2009sufe.npz,3001,12304,9303,5197,5839,642,2196,-6465,8661,0.9917208,0.9967044
GE.GSI.SH.gfz2012nrpy.npz,3000,4304,1304,9273,4243,5030,6273,-61,6334,0.99964035,0.99997807
GE.SMRI.BH.gfz2018hcuv.npz,3001,848,2153,5522,787,4735,2521,-61,2582,0.99989307,0.9999957
GE.TNTI.BL.gfz2009dijd.npz,3002,5450,2448,5353,7763,2410,2351,2313,38,0.97631526,0.9927752
GE.SANI.BL.gfz2015thvg.npz,3001,3248,247,6553,3234,3319,3552,-14,3566,0.9985947,0.9994947
GE.TNTI.BL.gfz2010abbl.npz,3001,5488,2487,4743,5583,840,1742,95,1647,0.9952938,0.99693453
GE.FAKI.BH.gfz2009oubh.npz,3001,15184,12183,8632,8804,172,5631,-6380,12011,0.9971023,0.99969673
GE.TNTI.BH.gfz2009eavu.npz,3002,14608,11606,8073,8563,490,5071,-6045,11116,0.98610526,0.9958674
GE.TNTI.BH.gfz2016mexu.npz,3002,12624,9622,3915,12611,8696,913,-13,926,0.99529845,0.99704427
GE.UGM.SH.gfz2015kylx.npz,3001,5056,2055,5107,5119,12,2106,63,2043,0.99677116,0.99960726
GE.UGM.BL.gfz2009boyf.npz,3001,784,2217,6030,723,5307,3029,-61,3090,0.999691,0.999889
GE.FAKI.SH.gfz2024quvs.npz,3001,8,2993,8616,211,8405,5615,203,5412,0.9997702,0.99990916
GE.FAKI.BH.gfz2009rhsi.npz,3001,7056,4055,7017,275,6742,4016,-6781,10797,0.9987564,0.99969983
GE.BNDI.BH.gfz2025fwkg.npz,3001,40,2961,5529,12499,6970,2528,12459,9931,0.99251854,0.99834204
GE.FAKI.BL.gfz2013avzn.npz,3001,7648,4647,7374,7570,196,4373,-78,4451,0.9968207,0.99970824
GE.FAKI.HL.gfz2009blcy.npz,3000,13760,10760,5905,3375,2530,2905,-10385,13290,0.99211043,0.9979243
GE.GSI.BH.gfz2025cdqz.npz,3001,15632,12631,5079,15635,10556,2078,3,2075,0.99841523,0.9996661
GE.TNTI.BH.gfz2009bmox.npz,3002,5488,2486,5029,5459,430,2027,-29,2056,0.9881616,0.9962149
GE.LUWI.BL.gfz2013qwcb.npz,3000,16592,13592,6053,467,5586,3053,-16125,19178,0.99246734,0.9933437
GE.TNTI.HH.gfz2009fgfn.npz,3000,14640,11640,6548,1811,4737,3548,-12829,16377,0.9994499,0.9999529
GE.LUWI.BH.gfz2017ukwz.npz,3001,4368,1367,4249,4383,134,1248,15,1233,0.99965036,0.9997503
GE.PLAI.SH.gfz2017nlxf.npz,3001,4880,1879,4473,4879,406,1472,-1,-1,0.994242,0.999371
GE.LUWI.BH.gfz2012widq.npz,3001,928,2073,5219,978,4241,2218,50,2168,0.99624556,0.99933076
GE.MNAI.BL.gfz2013uvlo.npz,3002,4240,1238,7637,4239,3398,4635,-1,-1,0.9941361,0.99896014
GE.MMRI.SH.gfz2012rbpj.npz,3001,3024,23,10204,15699,5495,7203,12675,5472,0.9916522,0.997326
GE.UGM.SH.gfz2012cipp.npz,3000,14888,11888,4696,14867,10171,1696,-21,1717,0.9986613,0.9998907
GE.GSI.SH.gfz2016rfim.npz,3001,14312,11311,4568,14291,9723,1567,-21,1588,0.995837,0.99973816
GE.SANI.SH.gfz2010ghiq.npz,3000,1040,1960,9709,1491,8218,6709,451,6258,0.99712807,0.9992279
GE.FAKI.BH.gfz2018qtuf.npz,3001,6064,3063,5929,5971,42,2928,-93,3021,0.9979323,0.9995097
GE.TOLI2.SH.gfz2014iwpt.npz,3000,14224,11224,6161,14195,8034,3161,-29,3190,0.9983156,0.9998103
GE.BNDI.BH.gfz2025dcky.npz,3001,1168,1833,6294,1155,5139,3293,-13,3306,0.99568707,0.99902284
GE.FAKI.BL.gfz2010abkc.npz,3001,8096,5095,7816,8051,235,4815,-45,4860,0.994478,0.99963915
GE.GSI.BH.gfz2012hidg.npz,3001,976,2025,5178,915,4263,2177,-61,2238,0.9953892,0.99968064
GE.SOEI.BL.gfz2014mnzy.npz,3001,10608,7607,4703,5459,756,1702,-5149,6851,0.9863783,0.9985549
GE.FAKI.HL.gfz2009byjb.npz,3000,7264,4264,7194,7263,69,4194,-1,-1,0.99816555,0.9997737
GE.MNAI.BL.gfz2020wrfa.npz,3001,3984,983,3937,4083,146,936,99,837,0.9930314,0.99693525
GE.JAGI.BL.gfz2023qwer.npz,3001,3344,343,8565,3364,5201,5564,20,5544,0.99680185,0.999608
GE.PLAI.SH.gfz2025ghay.npz,3000,3024,24,4791,3091,1700,1791,67,1724,0.9999132,0.9998789
GE.MNAI.SH.gfz2009xyqn.npz,3000,4122,1122,4085,4115,30,1085,-7,1092,0.9922416,0.9995592
GE.JAGI.HH.gfz2009bjnh.npz,3000,14608,11608,13085,12883,202,10085,-1725,11810,0.9947524,0.9987721
GE.BNDI.BL.gfz2010ghiq.npz,3001,464,2537,5661,403,5258,2660,-61,2721,0.98807764,0.99667275
GE.JAGI.SH.gfz2024wupd.npz,3001,560,2441,10182,531,9651,7181,-29,7210,0.99911314,0.99993074
GE.TNTI.BL.gfz2009sidp.npz,3001,5168,2167,4938,5139,201,1937,-29,1966,0.99927753,0.99889565
GE.FAKI.BH.gfz2012xahl.npz,3001,296,2705,6339,275,6064,3338,-21,3359,0.9990194,0.9999621
GE.FAKI.HL.gfz2009ennn.npz,3000,336,2664,7655,7842,187,4655,7506,2851,0.99388313,0.9971674
GE.UGM.HH.gfz2009inbh.npz,3000,1064,1936,5968,1043,4925,2968,-21,2989,0.9974849,0.9997986
GE.UGM.HL.gfz2009bbud.npz,3000,5530,2530,5426,5523,97,2426,-7,2433,0.98854136,0.9992473
GE.MNAI.SH.gfz2012wvgj.npz,3000,12432,9432,5307,12435,7128,2307,3,2304,0.9978046,0.99929726
GE.PLAI.SH.gfz2012qetk.npz,3001,272,2729,7071,275,6796,4070,3,4067,0.9898364,0.9989095
GE.FAKI.BL.gfz2009bjnh.npz,3001,6704,3703,6603,6723,120,3602,19,3583,0.9980094,0.9999411
GE.MNAI.BL.gfz2009pxkx.npz,3002,1192,1810,6811,1171,5640,3809,-21,3830,0.9817561,0.99821484
GE.UGM.SL.gfz2010cvnw.npz,3000,6688,3688,4749,6690,1941,1749,2,1747,0.99915755,0.9998271
GE.SANI.BL.gfz2025ewvp.npz,3001,14896,11895,10172,14882,4710,7171,-14,7185,0.99747187,0.9995753
GE.UGM.BH.gfz2010cvnw.npz,3001,6704,3703,4750,6675,1925,1749,-29,1778,0.99997103,0.99994624
GE.LUWI.SH.gfz2013fqap.npz,3001,4560,1559,4552,531,4021,1551,-4029,5580,0.9937255,0.99766505
GE.SANI.BL.gfz2013ykdd.npz,3001,3504,503,11532,3475,8057,8531,-29,8560,0.99231577,0.9987232
GE.BKNI.SH.gfz2019ckqw.npz,3001,4938,1937,4922,4883,39,1921,-55,1976,0.9928659,0.9985405
GE.UGM.SH.gfz2014ojjv.npz,3000,304,2696,4895,275,4620,1895,-29,1924,0.99738973,0.9997044
GE.TOLI2.SH.gfz2024vdim.npz,3000,240,2760,11193,211,10982,8193,-29,8222,0.9954367,0.99967134
GE.TNTI.BL.gfz2017sglz.npz,3002,3280,278,4663,3298,1365,1661,18,1643,0.9663725,0.9931084
GE.BNDI.BH.gfz2024urkq.npz,3001,15152,12151,8448,15123,6675,5447,-29,5476,0.9981766,0.99992
GE.FAKI.BL.gfz2010gdlm.npz,3001,7984,4983,7888,8100,212,4887,116,4771,0.9937389,0.99849
GE.FAKI.HH.gfz2009bjlo.npz,3000,8080,5080,5960,15123,9163,2960,7043,4083,0.995531,0.9988373
GE.LHMI.SH.gfz2010wlnb.npz,3000,1040,1960,5103,1043,4060,2103,3,2100,0.9995059,0.9999366
GE.SANI.BH.gfz2013yfsc.npz,3001,976,2025,10540,979,9561,7539,3,7536,0.9935655,0.9982699
GE.SANI.SH.gfz2010occd.npz,3000,7456,4456,7024,7507,483,4024,51,3973,0.989603,0.99926287
GE.TNTI.BH.gfz2009fgfn.npz,3001,14640,11639,6549,1811,4738,3548,-12829,16377,0.9994467,0.99995315
GE.LUWI.BH.gfz2012xqdd.npz,3001,13008,10007,9250,13139,3889,6249,131,6118,0.9917551,0.9977241
GE.LUWI.BL.gfz2013fqap.npz,3001,4624,1623,4552,4947,395,1551,323,1228,0.9969093,0.99874336
GE.FAKI.SH.gfz2014ubqb.npz,3001,1712,1289,6766,6803,37,3765,5091,1326,0.99365085,0.9995283
GE.TOLI2.BH.gfz2024krts.npz,3001,1168,1833,6470,6995,525,3469,5827,2358,0.9978115,0.9989674
GE.TNTI.SH.gfz2016mexu.npz,3000,12624,9624,3913,12611,8698,913,-13,926,0.9936963,0.996567
GE.FAKI.SH.gfz2009yode.npz,3001,6112,3111,5932,6114,182,2931,2,2929,0.9959376,0.9996094
GE.TNTI.BL.gfz2012rrwm.npz,3000,16688,13688,5826,16723,10897,2826,35,2791,0.9745627,0.99487656
GE.SANI.BL.gfz2010awor.npz,3001,7504,4503,7397,3283,4114,4396,-4221,8617,0.9985555,0.99969864
GE.TOLI2.SH.gfz2018hbkr.npz,3001,5232,2231,5160,211,4949,2159,-5021,7180,0.9992937,0.99772495
GE.FAKI.HL.gfz2009bjnh.npz,3000,6730,3730,6602,6723,121,3602,-7,3609,0.9971733,0.99983907
GE.GENI.BH.gfz2018umjj.npz,3001,4496,1495,4466,13779,9313,1465,9283,7818,0.997951,0.99957055
GE.UGM.BL.gfz2012lnpl.npz,3001,5104,2103,4805,5395,590,1804,291,1513,0.991931,0.99951243
GE.TNTI.BL.gfz2009floe.npz,3001,3360,359,7647,3283,4364,4646,-77,4723,0.9748784,0.99748576
GE.GENI.BL.gfz2012nver.npz,3001,4128,1127,3966,4019,53,965,-109,1074,0.99266654,0.99921954
GE.SOEI.SH.gfz2018hode.npz,3001,1296,1705,3731,1235,2496,730,-61,791,0.99839705,0.99989927
GE.UGM.HH.gfz2009ptvf.npz,3000,14864,11864,4987,531,4456,1987,-14333,16320,0.99785256,0.99970526
GE.LUWI.BH.gfz2009ayxo.npz,3001,14672,11671,8473,11795,3322,5472,-2877,8349,0.9940398,0.9972904
GE.FAKI.BL.gfz2009brqi.npz,3001,7192,4191,7069,7187,118,4068,-5,4073,0.99342865,0.99960965
GE.MNAI.BH.gfz2010veze.npz,3001,272,2729,4500,1171,3329,1499,899,600,0.9932632,0.99947125
GE.MMRI.HL.gfz2009iayl.npz,3000,12384,9384,8269,12563,4294,5269,179,5090,0.98618317,0.9961636
GE.MNAI.SH.gfz2013mcso.npz,3001,1456,1545,5415,1427,3988,2414,-29,2443,0.9956125,0.99975556
GE.GSI.BL.gfz2015bvov.npz,3001,4016,1015,3885,4015,130,884,-1,-1,0.99789065,0.9988998
GE.TNTI.HL.gfz2009qsnk.npz,3000,7856,4856,7319,7891,572,4319,35,4284,0.9800519,0.9974226
GE.SOEI.BL.gfz2023jjmg.npz,3000,3504,504,8761,10195,1434,5761,6691,930,0.9954079,0.99919635
GE.BKB.SH.gfz2023qwer.npz,3001,14352,11351,10770,14291,3521,7769,-61,7830,0.9946891,0.99939466
GE.TNTI.SH.gfz2018lwgs.npz,3001,8528,5527,7595,8531,936,4594,3,4591,0.99506515,0.99822074
GE.SOEI.SH.gfz2013pyhb.npz,3000,5136,2136,9330,2259,7071,6330,-2877,9207,0.9966813,0.9995353
GE.PLAI.BL.gfz2014esmj.npz,3001,6480,3479,6214,1171,5043,3213,-5309,8522,0.99142355,0.9927384
GE.JAGI.HH.gfz2009bbud.npz,3000,16848,13848,8660,1683,6977,5660,-15165,20825,0.9883713,0.9982742
GE.TNTI.HH.gfz2009dseu.npz,3000,8,2992,6480,7251,771,3480,7243,3763,0.9922212,0.9980082
GE.TOLI2.BL.gfz2024cmtg.npz,3001,4400,1399,4168,4243,75,1167,-157,1324,0.99138534,0.9983577
GE.SANI.SH.gfz2023kcmg.npz,3000,3312,312,9600,10387,787,6600,7075,475,0.9973711,0.99974877
GE.TOLI2.BH.gfz2025dygb.npz,3001,10704,7703,8049,14611,6562,5048,3907,1141,0.9989158,0.9998621
GE.LUWI.BL.gfz2009qgjm.npz,3002,8,2994,8471,15251,6780,5469,15243,9774,0.9889387,0.9966798
GE.SOEI.HH.gfz2010kolf.npz,3000,10640,7640,9897,5075,4822,6897,-5565,12462,0.9966859,0.99943763
GE.LUWI.SH.gfz2024fyvc.npz,3000,544,2456,6674,531,6143,3674,-13,3687,0.9973863,0.9998099
GE.TNTI.HL.gfz2009bjnh.npz,3000,12688,9688,9468,4322,5146,6468,-8366,14834,0.9848049,0.9918962
GE.BBJI.SH.gfz2024imhv.npz,3001,3792,791,13085,3795,9290,10084,3,10081,0.9973562,0.9992005
GE.TNTI.BH.gfz2014hjch.npz,3001,4432,1431,4447,4403,44,1446,-29,1475,0.99685365,0.9983188
GE.GSI.SH.gfz2010ncnk.npz,3000,8,2992,5452,467,4985,2452,459,1993,0.99998033,0.99988174
GE.SANI.SH.gfz2010antw.npz,3000,3216,216,7367,3283,4084,4367,67,4300,0.99793744,0.9994178
GE.JAGI.BH.gfz2024wupd.npz,3000,560,2440,10181,531,9650,7181,-29,7210,0.99945086,0.9999609
GE.TNTI.HL.gfz2012atdb.npz,3000,416,2584,7513,403,7110,4513,-13,4526,0.98785245,0.9959306
GE.PLAI.BH.gfz2013vwga.npz,3001,3472,471,3381,3379,2,380,-93,473,0.9989458,0.99992836
GE.TOLI2.SH.gfz2024stnc.npz,3000,144,2856,6049,164,5885,3049,20,3029,0.9998324,0.9999927
GE.JAGI.BH.gfz2023gnmu.npz,3000,5216,2216,4953,5218,265,1953,2,1951,0.9872798,0.9987901
GE.MMRI.SH.gfz2013ribh.npz,3000,5968,2968,4454,13523,9069,1454,7555,6101,0.9905387,0.99567324
GE.TNTI.BL.gfz2017ayqr.npz,3001,4784,1783,4346,4770,424,1345,-14,1359,0.9894275,0.99487597
GE.TOLI2.BH.gfz2024cmtg.npz,3001,4224,1223,4168,4307,139,1167,83,1084,0.9972293,0.99979776
GE.SAUI.BH.gfz2013qvir.npz,3001,13424,10423,6882,15123,8241,3881,1699,2182,0.98851854,0.9963168
GE.UGM.BH.gfz2009rejp.npz,3002,2896,106,6607,2883,3724,3605,-13,3618,0.99925166,0.9997278
GE.SMRI.SH.gfz2012uneo.npz,3000,10408,7408,6917,10387,3470,3917,-21,3938,0.9995622,0.99996936
GE.TOLI2.BL.gfz2024vdim.npz,3001,7664,4663,11194,7571,3623,8193,-93,8286,0.9872951,0.99858594
GE.JAGI.SH.gfz2018mwlr.npz,3001,15888,12887,4850,4979,129,1849,-10909,12758,0.9916979,0.99848676
GE.PLAI.BH.gfz2019qkjz.npz,3001,4840,1839,4497,5075,578,1496,235,1261,0.997081,0.99967325
GE.PLAI.BH.gfz2025amik.npz,3001,13552,10551,5068,13523,8455,2067,-29,2096,0.9979741,0.99979204
GE.MMRI.BH.gfz2025fwkg.npz,3002,12240,9238,12144,12243,99,9142,3,9139,0.9933416,0.99503314
GE.BNDI.BL.gfz2023dips.npz,3002,7264,4262,6333,7251,918,3331,-13,3344,0.993789,0.99947566
GE.MNAI.BL.gfz2018yajs.npz,3001,5296,2295,4976,5331,355,1975,35,1940,0.9869201,0.99531376
GE.TOLI2.BH.gfz2017zisk.npz,3001,15344,12343,3614,15315,11701,613,-29,642,0.99343336,0.9991033
GE.SANI.BH.gfz2025ewvp.npz,3001,8144,5143,10172,8083,2089,7171,-61,7232,0.9987675,0.99993956
GE.PLAI.BL.gfz2017ddhx.npz,3001,6448,3447,6218,6547,329,3217,99,3118,0.9950858,0.9990196
GE.UGM.SL.gfz2015vcni.npz,3000,4768,1768,4541,4691,150,1541,-77,1618,0.9874533,0.9984112
GE.LUWI.BH.gfz2013ghxx.npz,3001,5066,2065,5045,403,4642,2044,-4663,6707,0.9884128,0.99403435
GE.FAKI.BH.gfz2025dcky.npz,3001,1424,1577,8234,1363,6871,5233,-61,5294,0.99996066,0.9999981
GE.SMRI.BL.gfz2010ddjw.npz,3000,400,2600,6484,8226,1742,3484,7826,4342,0.9895237,0.99356973
GE.UGM.BL.gfz2009rejp.npz,3002,7498,4496,6607,14099,7492,3605,6601,2996,0.9914671,0.9989472
GE.UGM.BH.gfz2015vcni.npz,3001,4960,1959,4542,4900,358,1541,-60,1601,0.9950841,0.99937856
GE.FAKI.SH.gfz2010ghiq.npz,3000,7464,4464,7380,7458,78,4380,-6,4386,0.9975859,0.9997224
GE.JAGI.SH.gfz2025bckw.npz,3000,8,2992,6921,659,6262,3921,651,3270,0.99980456,0.99992955
GE.PLAI.SH.gfz2018hcmv.npz,3001,4266,1265,4252,4243,9,1251,-23,1274,0.99978644,0.9990971
GE.SANI.BL.gfz2024imhv.npz,3001,3184,183,7927,3315,4612,4926,131,4795,0.9882443,0.99817836
GE.SAUI.BL.gfz2009rpju.npz,3001,6016,3015,5302,6050,748,2301,34,2267,0.9935714,0.99485105
GE.TNTI.BL.gfz2009zjqg.npz,3001,6368,3367,5763,6291,528,2762,-77,2839,0.98467654,0.9982102
GE.FAKI.HL.gfz2009bjlo.npz,3000,6064,3064,5960,6099,139,2960,35,2925,0.9801501,0.99593556
GE.TNTI.BH.gfz2011ywdf.npz,3001,15632,12631,4745,15619,10874,1744,-13,1757,0.9998933,0.9999819
GE.TNTI.BH.gfz2012yhuy.npz,3002,7696,4694,7569,15187,7618,4567,7491,2924,0.9968266,0.9985446
GE.SANI.SH.gfz2022bkjt.npz,3000,5136,2136,8592,16403,7811,5592,11267,5675,0.99139696,0.9972218
GE.GSI.BL.gfz2021jpkx.npz,3001,3056,55,4984,5026,42,1983,1970,13,0.97602546,0.9924804
GE.BNDI.SH.gfz2024urkq.npz,3001,15152,12151,8448,15123,6675,5447,-29,5476,0.9981912,0.99992156
GE.JAGI.BL.gfz2012rjhn.npz,3001,3088,87,5778,3106,2672,2777,18,2759,0.9904518,0.99794513
GE.UGM.BL.gfz2009npjw.npz,3001,1168,1833,5551,467,5084,2550,-701,3251,0.9950884,0.9994361
GE.UGM.BL.gfz2018iouz.npz,3001,5168,2167,5081,3298,1783,2080,-1870,3950,0.995434,0.9978308
GE.SANI.BL.gfz2022xote.npz,3001,7136,4135,6702,3298,3404,3701,-3838,7539,0.98891944,0.99804354
GE.SOEI.BH.gfz2025fshn.npz,3001,496,2505,8695,467,8228,5694,-29,5723,0.999148,0.9999534
GE.JAGI.BL.gfz2014esmj.npz,3001,4848,1847,4598,4851,253,1597,3,1594,0.9957575,0.9983759
GE.TNTI.HH.gfz2009pyad.npz,3000,3728,728,7692,3667,4025,4692,-61,4753,0.9995364,0.99981445
GE.GSI.BH.gfz2010yvmm.npz,3001,16528,13527,5890,16467,10577,2889,-61,2950,0.9820629,0.997621
GE.BNDI.SH.gfz2021jacz.npz,3000,12752,9752,4993,5924,931,1993,-6828,8821,0.99665546,0.99853575
GE.JAGI.BH.gfz2012qetk.npz,3001,4368,1367,4295,4386,91,1294,18,1276,0.99979156,0.99969256
GE.TNTI.BL.gfz2009dctr.npz,3002,3856,854,6920,7443,523,3918,3587,331,0.98065186,0.9964233
GE.BBJI.SH.gfz2024kkci.npz,3000,912,2088,8116,851,7265,5116,-61,5177,0.9984812,0.9996118
GE.SAUI.BL.gfz2014brdi.npz,3001,5280,2279,4658,5282,624,1657,2,1655,0.9968393,0.9995408
GE.LHMI.BH.gfz2016xzgq.npz,3001,15056,12055,4119,11987,7868,1118,-3069,4187,0.9943557,0.9992508
GE.LHMI.SH.gfz2013qpmq.npz,3000,15952,12952,7921,15891,7970,4921,-61,4982,0.99915135,0.99966955
GE.PLAI.SH.gfz2012ilqg.npz,3000,5018,2018,4887,5075,188,1887,57,1830,0.99161154,0.9996307
GE.TOLI2.SH.gfz2013ghxx.npz,3000,7216,4216,6552,7315,763,3552,99,3453,0.99568754,0.9997056
GE.TNTI.SH.gfz2014emyz.npz,3000,8432,5432,8137,8403,266,5137,-29,5166,0.989384,0.9988354
GE.BNDI.BL.gfz2012xahl.npz,3001,5936,2935,5813,5935,122,2812,-1,-1,0.9938577,0.99847513
GE.SOEI.BH.gfz2012amyi.npz,3001,11088,8087,10378,275,10103,7377,-10813,18190,0.9975368,0.99887305
GE.SOEI.BH.gfz2010kolf.npz,3001,10640,7639,9898,5075,4823,6897,-5565,12462,0.998464,0.99966455
GE.FAKI.SH.gfz2025dcky.npz,3001,1424,1577,8234,1363,6871,5233,-61,5294,0.99995255,0.9999976
GE.JAGI.HL.gfz2009bkhv.npz,3000,416,2584,5823,339,5484,2823,-77,2900,0.99934536,0.99994147
GE.MMRI.SH.gfz2025fwkg.npz,3001,12240,9239,12143,12243,100,9142,3,9139,0.98935914,0.9927719
GE.JAGI.BH.gfz2009bbud.npz,3001,16848,13847,8661,1683,6978,5660,-15165,20825,0.9907747,0.9985372
GE.SOEI.BL.gfz2013tulg.npz,3002,368,2634,8351,275,8076,5349,-93,5442,0.9985971,0.9999391
GE.SOEI.HL.gfz2009psbv.npz,3000,8848,5848,8427,9395,968,5427,547,4880,0.9848734,0.99700445
GE.FAKI.HH.gfz2009amcp.npz,3000,16208,13208,6069,16147,10078,3069,-61,3130,0.999183,0.9999676
GE.SAUI.BL.gfz2012rbpj.npz,3001,16528,13527,5751,13523,7772,2750,-3005,5755,0.99504435,0.99105823
GE.JAGI.BL.gfz2013jndg.npz,3001,3082,81,6825,3103,3722,3824,21,3803,0.9946748,0.99758697
GE.MMRI.BL.gfz2009ilut.npz,3002,10864,7862,9477,5331,4146,6475,-5533,12008,0.98603094,0.99142903
GE.TNTI.HH.gfz2009floe.npz,3000,3312,312,7646,3343,4303,4646,31,4615,0.9971686,0.9972721
GE.BBJI.SH.gfz2024tufl.npz,3001,3248,247,6501,3283,3218,3500,35,3465,0.9973239,0.99995494
GE.PLAI.SH.gfz2018pmjk.npz,3001,6064,3063,5199,6035,836,2198,-29,2227,0.99533045,0.99931
GE.PLAI.BH.gfz2023sjso.npz,3001,4520,1519,4414,4516,102,1413,-4,1417,0.9991937,0.99986935
GE.UGM.BL.gfz2013ttpe.npz,3000,13008,10008,4938,5154,216,1938,-7854,9792,0.9949196,0.998211
GE.SMRI.BH.gfz2013qeoy.npz,3001,848,2153,5994,787,5207,2993,-61,3054,0.99925166,0.99991786
GE.UGM.BL.gfz2012kaia.npz,3001,4640,1639,4409,4563,154,1408,-77,1485,0.9962011,0.99924076
GE.BNDI.BL.gfz2023jjmg.npz,3002,12592,9590,11087,11795,708,8085,-797,8882,0.9900997,0.99844724
GE.FAKI.SH.gfz2014genx.npz,3001,16272,13271,6226,16211,9985,3225,-61,3286,0.99921954,0.99992085
GE.LUWI.BL.gfz2009boun.npz,3002,240,2762,4399,275,4124,1397,35,1362,0.99954,0.9999559
GE.TNTI.SH.gfz2014fzbl.npz,3000,5008,2008,4712,5331,619,1712,323,1389,0.9949851,0.99940467
GE.FAKI.SH.gfz2011ycjg.npz,3000,1168,1832,9819,1171,8648,6819,3,6816,0.9953057,0.9990164
GE.TNTI.SH.gfz2013udpf.npz,3001,8,2993,4565,5075,510,1564,5067,3503,0.9730204,0.99060035
GE.LUWI.BL.gfz2011xxju.npz,3001,8560,5559,8322,8531,209,5321,-29,5350,0.9678968,0.9927328
GE.LUWI.BH.gfz2009itjx.npz,3001,3632,631,8637,3603,5034,5636,-29,5665,0.9784267,0.9981729
GE.SANI.BH.gfz2024hgro.npz,3001,16848,13847,7988,16787,8799,4987,-61,5048,0.99852496,0.9997782
GE.SANI.SH.gfz2011xxju.npz,3001,5488,2487,5398,5459,61,2397,-29,2426,0.9869034,0.9994573
GE.GSI.BL.gfz2010ncnk.npz,3001,8,2993,5453,5651,198,2452,5643,3191,0.9967624,0.99917054
GE.UGM.SH.gfz2011yfab.npz,3001,16368,13367,6670,16339,9669,3669,-29,3698,0.99829465,0.999925
GE.SANI.SH.gfz2013ucyl.npz,3001,3408,407,9919,3362,6557,6918,-46,6964,0.9943211,0.9992924
GE.GSI.BH.gfz2009dygp.npz,3001,14032,11031,3913,13971,10058,912,-61,973,0.9961572,0.9988439
GE.TNTI.BL.gfz2009eqqh.npz,3001,4576,1575,4182,4386,204,1181,-190,1371,0.96643126,0.99253464
GE.SAUI.BH.gfz2014brdi.npz,3001,5280,2279,4658,5331,673,1657,51,1606,0.9932827,0.9993098
GE.PLAI.BH.gfz2025bmwa.npz,3001,1424,1577,5233,1363,3870,2232,-61,2293,0.99781585,0.9997633
GE.TNTI.SH.gfz2019sgac.npz,3001,8144,5143,5309,8131,2822,2308,-13,2321,0.9904254,0.99596834
GE.SOEI.BH.gfz2009psbv.npz,3001,15536,12535,8428,15507,7079,5427,-29,5456,0.99664366,0.9996387
GE.MNAI.BL.gfz2009qkfw.npz,3001,7088,4087,5857,6547,690,2856,-541,3397,0.9826126,0.99172723
GE.JAGI.BH.gfz2009bkhv.npz,3001,208,2793,5824,211,5613,2823,3,2820,0.99693596,0.99937457
GE.MNAI.BL.gfz2013goiq.npz,3001,4208,1207,4036,4207,171,1035,-1,-1,0.9992601,0.9994986
GE.MMRI.BH.gfz2009pxvj.npz,3001,4848,1847,8395,4179,4216,5394,-669,6063,0.9965125,0.9990915
GE.UGM.BH.gfz2018hcuv.npz,3001,4624,1623,4590,16275,11685,1589,11651,10062,0.99906486,0.99934536
GE.TNTI.HL.gfz2009eavu.npz,3000,15280,12280,8071,15311,7240,5071,31,5040,0.97016025,0.9916231
GE.FAKI.BL.gfz2009apup.npz,3002,5962,2960,5920,6163,243,2918,201,2717,0.9954886,0.9993605
GE.LUWI.BL.gfz2013pxfu.npz,3001,5200,2199,4833,4883,50,1832,-317,2149,0.9973013,0.99754035
GE.MNAI.BH.gfz2021lyjz.npz,3001,15072,12071,3840,15059,11219,839,-13,852,0.9844193,0.996027
GE.PLAI.SL.gfz2012azkx.npz,3000,4568,1568,4447,4563,116,1447,-5,1452,0.99039286,0.9994005
GE.LUWI.HL.gfz2009bjnh.npz,3000,6928,3928,11852,6867,4985,8852,-61,8913,0.9886097,0.9990715
GE.LHMI.BL.gfz2023acqq.npz,3001,3744,743,3337,3635,298,336,-109,445,0.9922694,0.9987967
GE.BNDI.BL.gfz2010abkc.npz,3001,6960,3959,6066,595,5471,3065,-6365,9430,0.93605286,0.9899699
GE.SOEI.BH.gfz2025bzud.npz,3001,3240,239,9172,3219,5953,6171,-21,6192,0.99413764,0.9991454
GE.TNTI.SH.gfz2023szzv.npz,3001,12688,9687,6972,12627,5655,3971,-61,4032,0.98567957,0.997707
GE.TNTI.BH.gfz2025czgt.npz,3001,3088,87,4240,4563,323,1239,1475,236,0.9873103,0.9968496
GE.TNTI.BL.gfz2012yhuy.npz,3002,8,2994,7569,228,7341,4567,220,4347,0.9979,0.9992029
GE.TNTI.BH.gfz2009dhbx.npz,3000,3568,568,6534,7123,589,3534,3555,21,0.99913436,0.99891376
GE.TNTI.BH.gfz2009pyad.npz,3001,3728,727,7693,3667,4026,4692,-61,4753,0.9994609,0.99985003
GE.JAGI.SH.gfz2014ghxq.npz,3000,4768,1768,4668,4755,87,1668,-13,1681,0.9827482,0.9987527
GE.SOEI.BH.gfz2009zbqz.npz,3001,10192,7191,9906,3347,6559,6905,-6845,13750,0.9986407,0.9997639
GE.LUWI.SH.gfz2024fmvg.npz,3001,5544,2543,7831,5523,2308,4830,-21,4851,0.9855516,0.997618
GE.TNTI.BH.gfz2015thvg.npz,3001,6352,3351,5645,6370,725,2644,18,2626,0.9902664,0.99719405
GE.TOLI2.BH.gfz2025dlfh.npz,3001,976,2025,5085,979,4106,2084,3,2081,0.9988237,0.99991536
GE.GSI.BL.gfz2010yvmm.npz,3001,6192,3191,5890,6195,305,2889,3,2886,0.9819786,0.994947
